ppt_id,dev_id,month,stream,perfect,nan,unclear,total_rows,total_dupes
mgh015,2KPY311192,20190501_20190531,temp,0,0,0,47180,0
mgh015,2KPY311192,20190501_20190531,acc,0,0,0,1499930,0
mgh015,2KPY311192,20190501_20190531,eda,0,0,0,188721,0
mgh012,2KNY3111NL,20190501_20190531,temp,69000,30,0,702789,69000
mgh012,2KNY3111NL,20190501_20190531,acc,2258060,0,896,23005202,2258956
mgh012,2KNY3111NL,20190501_20190531,eda,275990,0,0,2810910,275990
mgh013,2KPY31116R,20190501_20190531,temp,540,3530,8,699871,548
mgh013,2KPY31116R,20190501_20190531,acc,25282,10430,2836,22767148,28118
mgh013,2KPY31116R,20190501_20190531,eda,3068,11375,60,2796536,3128
mgh014,2KPY311174,20190501_20190531,temp,111300,0,0,251479,111300
mgh014,2KPY311174,20190501_20190531,acc,3608560,0,188,8182410,3608748
mgh014,2KPY311174,20190501_20190531,eda,445172,0,2,1005888,445174
mgh007,2KPY31119V,20190501_20190531,temp,0,0,0,789423,0
mgh007,2KPY31119V,20190501_20190531,acc,0,0,0,25389913,0
mgh007,2KPY31119V,20190501_20190531,eda,0,0,0,3157589,0
mgh009,2KPY31117K,20190501_20190531,temp,663488,515,2,949893,663490
mgh009,2KPY31117K,20190501_20190531,acc,21579004,0,1503,30883794,21580507
mgh009,2KPY31117K,20190501_20190531,eda,2653738,858,14,3798258,2653752
mgh008,2KNY3111L4,20190501_20190531,temp,0,1115,2,60780,2
mgh008,2KNY3111L4,20190501_20190531,acc,0,2260,164,1901090,164
mgh008,2KNY3111L4,20190501_20190531,eda,0,1144,12,239811,12
mgh001,2KNY3111P2,20190501_20190531,temp,940,89840,136,1360638,1076
mgh001,2KNY3111P2,20190501_20190531,acc,30362,115440,12471,41111093,42833
mgh001,2KNY3111P2,20190501_20190531,eda,3796,156585,644,5239571,4440
mgh006,2KPY31119G,20190501_20190531,temp,1219550,100,0,1946705,1219550
mgh006,2KPY31119G,20190501_20190531,acc,39822400,0,703,63567835,39823103
mgh006,2KPY31119G,20190501_20190531,eda,4877574,0,105,7786121,4877679
mgh018,2KPY31116V,20190501_20190531,temp,0,0,0,6630,0
mgh018,2KPY31116V,20190501_20190531,acc,0,0,0,211660,0
mgh018,2KPY31116V,20190501_20190531,eda,0,0,0,26533,0
mgh010,2KNY311222,20190501_20190531,temp,42774,0,0,368059,42774
mgh010,2KNY311222,20190501_20190531,acc,1366194,0,0,11746784,1366194
mgh010,2KNY311222,20190501_20190531,eda,171084,0,0,1472189,171084
mgh005,2KNY311223,20190501_20190531,temp,35780,425,0,148270,35780
mgh005,2KNY311223,20190501_20190531,acc,1166560,0,1882,4825700,1168442
mgh005,2KNY311223,20190501_20190531,eda,143104,1742,91,593073,143195
mgh002,2KNY3111LY,20190501_20190531,temp,0,0,0,3880,0
mgh002,2KNY3111LY,20190501_20190531,acc,0,0,0,125860,0
mgh002,2KNY3111LY,20190501_20190531,eda,0,0,0,15522,0
mgh001,2KNY3111P2,20190701_20190731,acc,0,0,0,0,0
mgh001,2KNY3111P2,20190701_20190731,eda,0,0,0,0,0
mgh001,2KNY3111P2,20190701_20190731,temp,0,0,0,0,0
mgh006,2KPY31119G,20190701_20190731,acc,0,0,0,82503133,0
mgh006,2KPY31119G,20190701_20190731,eda,0,0,14,10129793,14
mgh006,2KPY31119G,20190701_20190731,temp,0,0,0,2532511,0
mgh007,2KPY31119V,20190701_20190731,acc,0,0,0,24370215,0
mgh007,2KPY31119V,20190701_20190731,eda,0,0,0,3018195,0
mgh007,2KPY31119V,20190701_20190731,temp,0,0,0,754570,0
mgh009,2KPY31117K,20190701_20190731,acc,0,0,0,48675545,0
mgh009,2KPY31117K,20190701_20190731,eda,0,0,0,5984919,0
mgh009,2KPY31117K,20190701_20190731,temp,0,0,0,1496268,0
mgh010,2KNY311222,20190701_20190731,acc,0,0,0,52374663,0
mgh010,2KNY311222,20190701_20190731,eda,0,0,0,6553243,0
mgh010,2KNY311222,20190701_20190731,temp,0,0,0,1638367,0
mgh012,2KNY3111NL,20190701_20190731,acc,0,0,0,20936983,0
mgh012,2KNY3111NL,20190701_20190731,eda,0,0,0,2560086,0
mgh012,2KNY3111NL,20190701_20190731,temp,0,0,0,640040,0
mgh018,2KPY31116R,20190701_20190731,acc,0,2630,0,6979538,0
mgh018,2KPY31116R,20190701_20190731,eda,0,923,0,853129,0
mgh018,2KPY31116R,20190701_20190731,temp,0,230,0,213283,0
mgh018,2KPY31116V,20190701_20190731,acc,0,0,0,10221700,0
mgh018,2KPY31116V,20190701_20190731,eda,0,0,0,1276106,0
mgh018,2KPY31116V,20190701_20190731,temp,0,0,0,319035,0
mgh001,2KNY3111P2,20190801_20190831,acc,39280,0,0,8382862,39280
mgh001,2KNY3111P2,20190801_20190831,eda,4888,0,0,1039750,4888
mgh001,2KNY3111P2,20190801_20190831,temp,1230,0,0,259955,1230
mgh006,2KPY31119G,20190801_20190831,acc,4486640,0,58,85854472,4486698
mgh006,2KPY31119G,20190801_20190831,eda,552734,0,2,10545699,552736
mgh006,2KPY31119G,20190801_20190831,temp,138190,10,0,2636514,138190
mgh007,2KPY31119V,20190801_20190831,acc,8180,0,0,49702043,8180
mgh007,2KPY31119V,20190801_20190831,eda,1014,0,0,6144961,1014
mgh007,2KPY31119V,20190801_20190831,temp,250,0,0,1536286,250
mgh009,2KPY31117K,20190801_20190831,acc,0,0,0,14491530,0
mgh009,2KPY31117K,20190801_20190831,eda,0,0,0,1780883,0
mgh009,2KPY31117K,20190801_20190831,temp,0,0,0,445235,0
mgh010,2KNY311222,20190801_20190831,acc,0,0,0,44826519,0
mgh010,2KNY311222,20190801_20190831,eda,0,0,0,5607380,0
mgh010,2KNY311222,20190801_20190831,temp,0,0,0,1401886,0
mgh012,2KNY3111NL,20190801_20190831,acc,0,0,0,17437021,0
mgh012,2KNY3111NL,20190801_20190831,eda,0,0,0,2130992,0
mgh012,2KNY3111NL,20190801_20190831,temp,0,0,0,532765,0
mgh018,2KPY31116R,20190801_20190831,acc,0,4590,0,17135620,0
mgh018,2KPY31116R,20190801_20190831,eda,0,1469,0,2088026,0
mgh018,2KPY31116R,20190801_20190831,temp,0,360,0,522011,0
mgh001,2KNY3111P2,20190601_20190630,acc,15920,91760,5152,24468055,21072
mgh001,2KNY3111P2,20190601_20190630,eda,1976,123968,252,3156228,2228
mgh001,2KNY3111P2,20190601_20190630,temp,500,42915,30,801016,530
mgh006,2KPY31119G,20190601_20190630,acc,47596460,0,153,105003866,47596613
mgh006,2KPY31119G,20190601_20190630,eda,5829460,104,2,12862890,5829462
mgh006,2KPY31119G,20190601_20190630,temp,1457400,0,0,3215781,1457400
mgh007,2KPY31119V,20190601_20190630,acc,0,0,0,14007995,0
mgh007,2KPY31119V,20190601_20190630,eda,0,0,0,1746124,0
mgh007,2KPY31119V,20190601_20190630,temp,0,0,0,436541,0
mgh008,2KNY3111L4,20190601_20190630,acc,0,0,0,1435080,0
mgh008,2KNY3111L4,20190601_20190630,eda,0,0,0,182364,0
mgh008,2KNY3111L4,20190601_20190630,temp,0,0,0,45595,0
mgh009,2KPY31117K,20190601_20190630,acc,30802812,40,6415,79683445,30809227
mgh009,2KPY31117K,20190601_20190630,eda,3788092,0,35,9799257,3788127
mgh009,2KPY31117K,20190601_20190630,temp,947090,0,5,2449876,947095
mgh010,2KNY311222,20190601_20190630,acc,2000602,0,43,47150099,2000645
mgh010,2KNY311222,20190601_20190630,eda,250212,130,14,5908717,250226
mgh010,2KNY311222,20190601_20190630,temp,62544,30,0,1477196,62544
mgh012,2KNY3111NL,20190601_20190630,acc,20931280,0,0,61841575,20931280
mgh012,2KNY3111NL,20190601_20190630,eda,2564510,0,0,7569417,2564510
mgh012,2KNY3111NL,20190601_20190630,temp,641140,0,0,1892410,641140
mgh013,2KPY31116R,20190601_20190630,acc,4,22110,222,8928450,226
mgh013,2KPY31116R,20190601_20190630,eda,0,23101,0,1119294,0
mgh013,2KPY31116R,20190601_20190630,temp,0,5770,0,279818,0
mgh017,2KPY31117F,20190601_20190630,acc,33780,20620,4169,18674960,37949
mgh017,2KPY31117F,20190601_20190630,eda,4160,39663,452,2343107,4612
mgh017,2KPY31117F,20190601_20190630,temp,1020,13715,92,589590,1112
mgh018,2KPY31116V,20190601_20190630,acc,0,760,0,6158930,0
mgh018,2KPY31116V,20190601_20190630,eda,0,715,0,771615,0
mgh018,2KPY31116V,20190601_20190630,temp,0,180,0,192895,0
mgh020,2KPY31113P,20190601_20190630,acc,0,0,0,4975350,0
mgh020,2KPY31113P,20190601_20190630,eda,0,0,0,622440,0
mgh020,2KPY31113P,20190601_20190630,temp,0,0,0,155615,0
mgh001,2KNY3111P2,20190901_20190930,acc,436320,480,0,38967395,436320
mgh001,2KNY3111P2,20190901_20190930,eda,54262,1001,0,4835258,54262
mgh001,2KNY3111P2,20190901_20190930,temp,13570,245,0,1208859,13570
mgh006,2KPY31119G,20190901_20190930,acc,756540,3820,3486,27601406,760026
mgh006,2KPY31119G,20190901_20190930,eda,92378,7657,135,3398367,92513
mgh006,2KPY31119G,20190901_20190930,temp,23120,16590,52,864310,23172
mgh007,2KPY31119V,20190901_20190930,acc,111380,0,0,33355868,111380
mgh007,2KPY31119V,20190901_20190930,eda,13702,0,0,4119131,13702
mgh007,2KPY31119V,20190901_20190930,temp,3420,0,0,1029812,3420
mgh010,2KNY311222,20190901_20190930,acc,0,0,0,37113625,0
mgh010,2KNY311222,20190901_20190930,eda,0,0,0,4654155,0
mgh010,2KNY311222,20190901_20190930,temp,0,0,0,1163572,0
mgh012,2KNY3111NL,20190901_20190930,acc,0,0,0,1984587,0
mgh012,2KNY3111NL,20190901_20190930,eda,0,0,0,243090,0
mgh012,2KNY3111NL,20190901_20190930,temp,0,0,0,60774,0
mgh006,2KPY31119G,20191001_20191031,acc,0,0,0,75141070,0
mgh006,2KPY31119G,20191001_20191031,eda,0,0,0,9223474,0
mgh006,2KPY31119G,20191001_20191031,temp,0,0,0,2305940,0
mgh007,2KPY31119V,20191001_20191031,acc,0,0,0,37346172,0
mgh007,2KPY31119V,20191001_20191031,eda,0,0,0,4631204,0
mgh007,2KPY31119V,20191001_20191031,temp,0,0,0,1157850,0
mgh010,2KNY311222,20191001_20191031,acc,0,0,0,27583170,0
mgh010,2KNY311222,20191001_20191031,eda,0,0,0,3472001,0
mgh010,2KNY311222,20191001_20191031,temp,0,0,0,868020,0
mgh012,2KNY3111NL,20191001_20191031,acc,0,0,0,21272900,0
mgh012,2KNY3111NL,20191001_20191031,eda,0,0,0,2602743,0
mgh012,2KNY3111NL,20191001_20191031,temp,0,0,0,650700,0
mgh018,2KPY31116R,20191001_20191031,acc,0,0,0,5504040,0
mgh018,2KPY31116R,20191001_20191031,eda,0,0,0,672282,0
mgh018,2KPY31116R,20191001_20191031,temp,0,0,0,168075,0
mgh007,2KPY31119V,20191101_20191130,acc,0,0,0,194676,0
mgh007,2KPY31119V,20191101_20191130,eda,0,0,0,24417,0
mgh007,2KPY31119V,20191101_20191130,temp,0,0,0,6104,0
mgh018,2KPY31116R,20191101_20191130,acc,0,0,0,7925070,0
mgh018,2KPY31116R,20191101_20191130,eda,0,0,0,974922,0
mgh018,2KPY31116R,20191101_20191130,temp,0,0,0,243740,0
mgh021,2KPY31117X,20190601_20190630,acc,0,0,0,3799140,0
mgh021,2KPY31117X,20190601_20190630,eda,0,0,0,468195,0
mgh021,2KPY31117X,20190601_20190630,temp,0,0,0,117055,0
mgh022,2KNY3111MM,20190601_20190630,acc,0,0,0,6153200,0
mgh022,2KNY3111MM,20190601_20190630,eda,0,0,0,767455,0
mgh022,2KNY3111MM,20190601_20190630,temp,0,0,0,191870,0
mgh023,2KPY31117C,20190601_20190630,acc,0,0,0,22917360,0
mgh023,2KPY31117C,20190601_20190630,eda,0,0,0,2814253,0
mgh023,2KPY31117C,20190601_20190630,temp,0,0,0,703585,0
mgh024,2KPY31117W,20190601_20190630,acc,0,0,0,34134110,0
mgh024,2KPY31117W,20190601_20190630,eda,0,0,0,4200794,0
mgh024,2KPY31117W,20190601_20190630,temp,0,0,0,1050220,0
mgh025,2KPY31119K,20190601_20190630,acc,0,0,0,27145630,0
mgh025,2KPY31119K,20190601_20190630,eda,0,0,0,3401710,0
mgh025,2KPY31119K,20190601_20190630,temp,0,0,0,850450,0
mgh026,2KPY31116L,20190601_20190630,acc,0,0,0,43998986,0
mgh026,2KPY31116L,20190601_20190630,eda,0,0,0,5369695,0
mgh026,2KPY31116L,20190601_20190630,temp,0,0,0,1342457,0
mgh027,2KPY311188,20190601_20190630,acc,0,0,0,16612934,0
mgh027,2KPY311188,20190601_20190630,eda,0,0,0,2043924,0
mgh027,2KPY311188,20190601_20190630,temp,0,0,0,510991,0
mgh028,2KPY311174,20190601_20190630,acc,0,0,0,28012437,0
mgh028,2KPY311174,20190601_20190630,eda,0,0,0,3422513,0
mgh028,2KPY311174,20190601_20190630,temp,0,0,0,855649,0
mgh029,2KPY31117Y,20190601_20190630,acc,0,0,0,5210130,0
mgh029,2KPY31117Y,20190601_20190630,eda,0,0,0,650221,0
mgh029,2KPY31117Y,20190601_20190630,temp,0,0,0,162560,0
mgh030,2KNY3111L9,20190601_20190630,acc,0,0,0,3047660,0
mgh030,2KNY3111L9,20190601_20190630,eda,0,0,0,377923,0
mgh030,2KNY3111L9,20190601_20190630,temp,0,0,0,94475,0
mgh032,2KPY31117T,20190601_20190630,acc,0,0,0,9264863,0
mgh032,2KPY31117T,20190601_20190630,eda,0,0,0,1152276,0
mgh032,2KPY31117T,20190601_20190630,temp,0,0,0,288078,0
mgh033,2KPY31113Q,20190601_20190630,acc,0,0,0,7178840,0
mgh033,2KPY31113Q,20190601_20190630,eda,0,0,0,875550,0
mgh033,2KPY31113Q,20190601_20190630,temp,0,0,0,218895,0
mgh035,2KPY311187,20190601_20190630,acc,0,0,0,5711245,0
mgh035,2KPY311187,20190601_20190630,eda,0,0,0,714256,0
mgh035,2KPY311187,20190601_20190630,temp,0,0,0,178570,0
mgh016,2KNY31121Q,20190701_20190731,acc,0,0,0,53336710,0
mgh016,2KNY31121Q,20190701_20190731,eda,0,0,0,6497855,0
mgh016,2KNY31121Q,20190701_20190731,temp,0,0,0,1624515,0
mgh023,2KPY31117C,20190701_20190731,acc,0,0,0,4303660,0
mgh023,2KPY31117C,20190701_20190731,eda,0,0,0,527982,0
mgh023,2KPY31117C,20190701_20190731,temp,0,0,0,132000,0
mgh024,2KPY31117W,20190701_20190731,acc,0,0,0,39673536,0
mgh024,2KPY31117W,20190701_20190731,eda,0,0,0,4880144,0
mgh024,2KPY31117W,20190701_20190731,temp,0,0,0,1220072,0
mgh026,2KPY31116L,20190701_20190731,acc,0,0,0,80880407,0
mgh026,2KPY31116L,20190701_20190731,eda,0,0,0,9864095,0
mgh026,2KPY31116L,20190701_20190731,temp,0,0,0,2466089,0
mgh027,2KPY311188,20190701_20190731,acc,0,0,0,80173118,0
mgh027,2KPY311188,20190701_20190731,eda,0,0,0,9864100,0
mgh027,2KPY311188,20190701_20190731,temp,0,0,0,2466113,0
mgh028,2KPY311174,20190701_20190731,acc,0,0,0,53484211,0
mgh028,2KPY311174,20190701_20190731,eda,0,0,0,6534878,0
mgh028,2KPY311174,20190701_20190731,temp,0,0,0,1633754,0
mgh029,2KPY31117Y,20190701_20190731,acc,0,0,16,37185969,16
mgh029,2KPY31117Y,20190701_20190731,eda,0,0,0,4641407,0
mgh029,2KPY31117Y,20190701_20190731,temp,0,0,0,1160379,0
mgh030,2KNY3111L9,20190701_20190731,acc,0,0,0,13512240,0
mgh030,2KNY3111L9,20190701_20190731,eda,0,0,0,1675817,0
mgh030,2KNY3111L9,20190701_20190731,temp,0,0,0,418965,0
mgh032,2KPY31117T,20190701_20190731,acc,0,0,0,64605375,0
mgh032,2KPY31117T,20190701_20190731,eda,0,0,0,8037758,0
mgh032,2KPY31117T,20190701_20190731,temp,0,0,0,2009501,0
mgh033,2KPY31113Q,20190701_20190731,acc,0,0,0,8091700,0
mgh033,2KPY31113Q,20190701_20190731,eda,0,0,0,991016,0
mgh033,2KPY31113Q,20190701_20190731,temp,0,0,0,247755,0
mgh035,2KPY311187,20190701_20190731,acc,0,0,0,59483553,0
mgh035,2KPY311187,20190701_20190731,eda,0,0,0,7459202,0
mgh035,2KPY311187,20190701_20190731,temp,0,0,0,1864854,0
mgh036,2KNY3111N4,20190701_20190731,acc,0,0,0,2592030,0
mgh036,2KNY3111N4,20190701_20190731,eda,0,0,0,326378,0
mgh036,2KNY3111N4,20190701_20190731,temp,0,0,0,81600,0
mgh037,2KPY31116K,20190701_20190731,acc,0,0,0,28422654,0
mgh037,2KPY31116K,20190701_20190731,eda,0,0,0,3517981,0
mgh037,2KPY31116K,20190701_20190731,temp,0,0,0,879520,0
mgh038,2KPY31119R,20190701_20190731,acc,0,0,0,40621350,0
mgh038,2KPY31119R,20190701_20190731,eda,0,0,0,5102370,0
mgh038,2KPY31119R,20190701_20190731,temp,0,0,0,1275625,0
mgh039,2KPY31118G,20190701_20190731,acc,0,0,0,110930,0
mgh039,2KPY31118G,20190701_20190731,eda,0,0,0,13520,0
mgh039,2KPY31118G,20190701_20190731,temp,0,0,0,3375,0
mgh040,2KPY31117M,20190701_20190731,acc,0,0,0,12296700,0
mgh040,2KPY31117M,20190701_20190731,eda,0,0,0,1527643,0
mgh040,2KPY31117M,20190701_20190731,temp,0,0,0,381925,0
mgh041,2KPY31117D,20190701_20190731,acc,0,0,0,2372470,0
mgh041,2KPY31117D,20190701_20190731,eda,0,0,0,296621,0
mgh041,2KPY31117D,20190701_20190731,temp,0,0,0,74160,0
mgh042,2KNY3111LM,20190701_20190731,acc,0,0,0,2618540,0
mgh042,2KNY3111LM,20190701_20190731,eda,0,0,0,330446,0
mgh042,2KNY3111LM,20190701_20190731,temp,0,0,0,82612,0
mgh043,2KPY31117J,20190701_20190731,acc,0,0,0,11450280,0
mgh043,2KPY31117J,20190701_20190731,eda,0,0,0,1425840,0
mgh043,2KPY31117J,20190701_20190731,temp,0,0,0,356470,0
mgh044,2KPY31117G,20190701_20190731,acc,0,0,0,8527286,0
mgh044,2KPY31117G,20190701_20190731,eda,0,0,0,1075680,0
mgh044,2KPY31117G,20190701_20190731,temp,0,0,0,268927,0
fc001,2KNY3111YF,20190801_20190831,acc,0,0,0,16518210,0
fc001,2KNY3111YF,20190801_20190831,eda,0,0,0,2057393,0
fc001,2KNY3111YF,20190801_20190831,temp,0,0,0,514365,0
fc002,2KNY3111YJ,20190801_20190831,acc,0,0,0,27253206,0
fc002,2KNY3111YJ,20190801_20190831,eda,0,0,0,3386887,0
fc002,2KNY3111YJ,20190801_20190831,temp,0,0,0,846776,0
fc003,2KPY31117N,20190801_20190831,acc,0,0,0,18635920,0
fc003,2KPY31117N,20190801_20190831,eda,0,0,0,2295111,0
fc003,2KPY31117N,20190801_20190831,temp,0,0,0,573795,0
mgh016,2KNY31121Q,20190801_20190831,acc,0,0,0,13662974,0
mgh016,2KNY31121Q,20190801_20190831,eda,0,0,0,1667527,0
mgh016,2KNY31121Q,20190801_20190831,temp,0,0,0,416893,0
mgh024,2KPY31117W,20190801_20190831,acc,0,0,0,26287175,0
mgh024,2KPY31117W,20190801_20190831,eda,0,0,0,3235999,0
mgh024,2KPY31117W,20190801_20190831,temp,0,0,0,809018,0
mgh026,2KPY31116L,20190801_20190831,acc,0,0,0,79865941,0
mgh026,2KPY31116L,20190801_20190831,eda,0,0,0,9752709,0
mgh026,2KPY31116L,20190801_20190831,temp,0,0,0,2438227,0
mgh027,2KPY311188,20190801_20190831,acc,0,0,0,81237733,0
mgh027,2KPY311188,20190801_20190831,eda,0,0,0,10000660,0
mgh027,2KPY311188,20190801_20190831,temp,0,0,0,2500229,0
mgh028,2KPY311174,20190801_20190831,acc,0,0,0,53503858,0
mgh028,2KPY311174,20190801_20190831,eda,0,0,0,6548131,0
mgh028,2KPY311174,20190801_20190831,temp,0,0,0,1637079,0
mgh029,2KPY31117Y,20190801_20190831,acc,0,0,0,59665531,0
mgh029,2KPY31117Y,20190801_20190831,eda,0,0,0,7449682,0
mgh029,2KPY31117Y,20190801_20190831,temp,0,0,0,1862466,0
mgh030,2KNY3111L9,20190801_20190831,acc,0,0,0,16452103,0
mgh030,2KNY3111L9,20190801_20190831,eda,0,0,0,2049363,0
mgh030,2KNY3111L9,20190801_20190831,temp,0,0,0,512360,0
mgh032,2KPY31117T,20190801_20190831,acc,0,0,0,50638510,0
mgh032,2KPY31117T,20190801_20190831,eda,0,0,0,6302025,0
mgh032,2KPY31117T,20190801_20190831,temp,0,0,0,1575530,0
mgh035,2KPY311187,20190801_20190831,acc,0,0,0,18483919,0
mgh035,2KPY311187,20190801_20190831,eda,0,0,0,2321629,0
mgh035,2KPY311187,20190801_20190831,temp,0,0,0,580419,0
mgh037,2KPY31116K,20190801_20190831,acc,0,0,0,54310277,0
mgh037,2KPY31116K,20190801_20190831,eda,0,0,0,6731288,0
mgh037,2KPY31116K,20190801_20190831,temp,0,0,0,1682870,0
mgh038,2KPY31119R,20190801_20190831,acc,0,0,0,27314070,0
mgh038,2KPY31119R,20190801_20190831,eda,0,0,0,3421379,0
mgh038,2KPY31119R,20190801_20190831,temp,0,0,0,855380,0
mgh040,2KPY31117M,20190801_20190831,acc,0,0,0,1797360,0
mgh040,2KPY31117M,20190801_20190831,eda,0,0,0,223301,0
mgh040,2KPY31117M,20190801_20190831,temp,0,0,0,55830,0
mgh042,2KNY3111LM,20190801_20190831,acc,0,0,96,3165598,96
mgh042,2KNY3111LM,20190801_20190831,eda,0,0,0,395639,0
mgh042,2KNY3111LM,20190801_20190831,temp,0,0,0,98907,0
mgh043,2KPY31117J,20190801_20190831,acc,0,0,0,35985029,0
mgh043,2KPY31117J,20190801_20190831,eda,0,0,0,4478594,0
mgh043,2KPY31117J,20190801_20190831,temp,0,0,0,1119677,0
mgh044,2KPY31117G,20190801_20190831,acc,0,0,0,1468313,0
mgh044,2KPY31117G,20190801_20190831,eda,0,0,0,187031,0
mgh044,2KPY31117G,20190801_20190831,temp,0,0,0,46757,0
mgh046,2KNY3111XG,20190801_20190831,acc,0,0,0,49867377,0
mgh046,2KNY3111XG,20190801_20190831,eda,0,0,0,6227678,0
mgh046,2KNY3111XG,20190801_20190831,temp,0,0,0,1556933,0
mgh047,2KPY311194,20190801_20190831,acc,0,0,0,23083730,0
mgh047,2KPY311194,20190801_20190831,eda,0,0,0,2858284,0
mgh047,2KPY311194,20190801_20190831,temp,0,0,0,714595,0
mgh048,2KNY3111NN,20190801_20190831,acc,0,0,0,2021900,0
mgh048,2KNY3111NN,20190801_20190831,eda,0,0,0,255138,0
mgh048,2KNY3111NN,20190801_20190831,temp,0,0,0,63785,0
mgh049,2KPY31118C,20190801_20190831,acc,0,0,0,37015120,0
mgh049,2KPY31118C,20190801_20190831,eda,0,0,0,4583761,0
mgh049,2KPY31118C,20190801_20190831,temp,0,0,0,1145990,0
mgh050,2KPY311175,20190801_20190831,acc,0,0,0,333590,0
mgh050,2KPY311175,20190801_20190831,eda,0,0,0,41236,0
mgh050,2KPY311175,20190801_20190831,temp,0,0,0,10310,0
mgh051,2KPY31119J,20190801_20190831,acc,0,0,0,21165648,0
mgh051,2KPY31119J,20190801_20190831,eda,0,0,0,2633181,0
mgh051,2KPY31119J,20190801_20190831,temp,0,0,0,658312,0
mgh052,2KNY3111M6,20190801_20190831,acc,0,0,0,1247120,0
mgh052,2KNY3111M6,20190801_20190831,eda,0,0,0,152737,0
mgh052,2KNY3111M6,20190801_20190831,temp,0,0,0,38185,0
mgh053,2KPY31118J,20190801_20190831,acc,0,0,0,4532360,0
mgh053,2KPY31118J,20190801_20190831,eda,0,0,0,569010,0
mgh053,2KPY31118J,20190801_20190831,temp,0,0,0,142255,0
mgh054,2KPY311184,20190801_20190831,acc,0,0,0,20814560,0
mgh054,2KPY311184,20190801_20190831,eda,0,0,0,2540213,0
mgh054,2KPY311184,20190801_20190831,temp,0,0,0,635070,0
fc002,2KNY3111YJ,20190901_20190930,acc,0,0,0,59618202,0
fc002,2KNY3111YJ,20190901_20190930,eda,0,0,0,7418046,0
fc002,2KNY3111YJ,20190901_20190930,temp,0,0,0,1854563,0
fc003,2KPY31117N,20190901_20190930,acc,0,0,0,73514760,0
fc003,2KPY31117N,20190901_20190930,eda,0,0,0,9058122,0
fc003,2KPY31117N,20190901_20190930,temp,0,0,0,2264593,0
fc006,2KPY311186,20190901_20190930,acc,0,0,0,17020,0
fc006,2KPY311186,20190901_20190930,eda,0,0,0,2093,0
fc006,2KPY311186,20190901_20190930,temp,0,0,0,520,0
fc007,2KNY3111HT,20190901_20190930,acc,0,0,0,3184310,0
fc007,2KNY3111HT,20190901_20190930,eda,0,0,0,401037,0
fc007,2KNY3111HT,20190901_20190930,temp,0,0,0,100265,0
fc008,2KNY3111YD,20190901_20190930,acc,0,0,0,64840,0
fc008,2KNY3111YD,20190901_20190930,eda,0,0,0,8099,0
fc008,2KNY3111YD,20190901_20190930,temp,0,0,0,2025,0
fc009,2KNY3111Y8,20190901_20190930,acc,0,0,0,642540,0
fc009,2KNY3111Y8,20190901_20190930,eda,0,0,0,81341,0
fc009,2KNY3111Y8,20190901_20190930,temp,0,0,0,20345,0
fc012,2KPY31118K,20190901_20190930,acc,0,0,0,162540,0
fc012,2KPY31118K,20190901_20190930,eda,0,0,0,20384,0
fc012,2KPY31118K,20190901_20190930,temp,0,0,0,5095,0
fc013,2KPY31113R,20190901_20190930,acc,0,0,0,3079950,0
fc013,2KPY31113R,20190901_20190930,eda,0,0,0,388674,0
fc013,2KPY31113R,20190901_20190930,temp,0,0,0,97170,0
mgh016,2KNY31121Q,20190901_20190930,acc,0,0,0,37618763,0
mgh016,2KNY31121Q,20190901_20190930,eda,0,0,0,4593880,0
mgh016,2KNY31121Q,20190901_20190930,temp,0,0,0,1148506,0
mgh024,2KPY31117W,20190901_20190930,acc,0,0,0,25554815,0
mgh024,2KPY31117W,20190901_20190930,eda,0,0,0,3148908,0
mgh024,2KPY31117W,20190901_20190930,temp,0,0,0,787248,0
mgh026,2KPY31116L,20190901_20190930,acc,0,0,0,55396854,0
mgh026,2KPY31116L,20190901_20190930,eda,0,0,0,6771356,0
mgh026,2KPY31116L,20190901_20190930,temp,0,0,0,1692881,0
mgh027,2KPY311188,20190901_20190930,acc,0,0,0,78649023,0
mgh027,2KPY311188,20190901_20190930,eda,0,0,0,9678338,0
mgh027,2KPY311188,20190901_20190930,temp,0,0,0,2419713,0
mgh028,2KPY311174,20190901_20190930,acc,0,0,0,15093987,0
mgh028,2KPY311174,20190901_20190930,eda,0,0,0,1848828,0
mgh028,2KPY311174,20190901_20190930,temp,0,0,0,462225,0
mgh029,2KPY31117Y,20190901_20190930,acc,0,0,0,79807188,0
mgh029,2KPY31117Y,20190901_20190930,eda,0,0,0,9960236,0
mgh029,2KPY31117Y,20190901_20190930,temp,3,0,3,2490116,6
mgh032,2KPY31117T,20190901_20190930,acc,0,0,0,77897860,0
mgh032,2KPY31117T,20190901_20190930,eda,0,0,0,9692537,0
mgh032,2KPY31117T,20190901_20190930,temp,0,0,0,2423223,0
mgh037,2KPY31116K,20190901_20190930,acc,0,0,0,18579325,0
mgh037,2KPY31116K,20190901_20190930,eda,0,0,0,2307501,0
mgh037,2KPY31116K,20190901_20190930,temp,0,0,0,576888,0
mgh043,2KPY31117J,20190901_20190930,acc,0,0,0,29873469,0
mgh043,2KPY31117J,20190901_20190930,eda,0,0,0,3725559,0
mgh043,2KPY31117J,20190901_20190930,temp,0,0,0,931422,0
mgh046,2KNY3111XG,20190901_20190930,acc,0,0,0,54277398,0
mgh046,2KNY3111XG,20190901_20190930,eda,0,0,0,6779085,0
mgh046,2KNY3111XG,20190901_20190930,temp,0,0,0,1694824,0
mgh047,2KPY311194,20190901_20190930,acc,0,0,0,6378620,0
mgh047,2KPY311194,20190901_20190930,eda,0,0,0,792662,0
mgh047,2KPY311194,20190901_20190930,temp,0,0,0,198165,0
mgh051,2KPY31119J,20190901_20190930,acc,0,0,0,12051350,0
mgh051,2KPY31119J,20190901_20190930,eda,0,0,0,1504247,0
mgh051,2KPY31119J,20190901_20190930,temp,0,0,0,376077,0
mgh054,2KPY311184,20190901_20190930,acc,0,0,0,41768970,0
mgh054,2KPY311184,20190901_20190930,eda,0,0,0,5113849,0
mgh054,2KPY311184,20190901_20190930,temp,0,0,0,1278500,0
mgh055,2KNY3111P8,20190901_20190930,acc,0,0,0,18542100,0
mgh055,2KNY3111P8,20190901_20190930,eda,0,0,0,2292901,0
mgh055,2KNY3111P8,20190901_20190930,temp,0,0,0,573240,0
fc002,2KNY3111YJ,20191001_20191031,acc,0,0,0,48429870,0
fc002,2KNY3111YJ,20191001_20191031,eda,0,0,0,6026930,0
fc002,2KNY3111YJ,20191001_20191031,temp,0,0,0,1506775,0
fc003,2KPY31117N,20191001_20191031,acc,0,0,0,43177608,0
fc003,2KPY31117N,20191001_20191031,eda,0,0,0,5328779,0
fc003,2KPY31117N,20191001_20191031,temp,0,0,0,1332231,0
fc007,2KNY3111HT,20191001_20191031,acc,0,0,8,2854020,8
fc007,2KNY3111HT,20191001_20191031,eda,0,0,0,357123,0
fc007,2KNY3111HT,20191001_20191031,temp,0,0,0,89285,0
fc009,2KNY3111Y8,20191001_20191031,acc,0,0,0,44428918,0
fc009,2KNY3111Y8,20191001_20191031,eda,0,0,0,5571867,0
fc009,2KNY3111Y8,20191001_20191031,temp,0,0,0,1393000,0
fc010,2KPY311199,20191001_20191031,acc,6020,0,0,53780441,6020
fc010,2KPY311199,20191001_20191031,eda,754,0,0,6739557,754
fc010,2KPY311199,20191001_20191031,temp,190,0,0,1684935,190
fc011,2KNY3111NJ,20191001_20191031,acc,0,0,0,33763004,0
fc011,2KNY3111NJ,20191001_20191031,eda,0,0,0,4184251,0
fc011,2KNY3111NJ,20191001_20191031,temp,0,0,0,1046088,0
fc012,2KPY31118K,20191001_20191031,acc,0,0,0,17229220,0
fc012,2KPY31118K,20191001_20191031,eda,0,0,0,2146248,0
fc012,2KPY31118K,20191001_20191031,temp,0,0,0,536585,0
fc013,2KPY31113R,20191001_20191031,acc,0,0,0,47676819,0
fc013,2KPY31113R,20191001_20191031,eda,0,0,0,5985489,0
fc013,2KPY31113R,20191001_20191031,temp,0,0,0,1496406,0
fc014,2KPY311181,20191001_20191031,acc,0,0,0,6660,0
fc014,2KPY311181,20191001_20191031,eda,0,0,0,832,0
fc014,2KPY311181,20191001_20191031,temp,0,0,0,210,0
fc015,2KPY311189,20191001_20191031,acc,0,0,0,17474240,0
fc015,2KPY311189,20191001_20191031,eda,0,0,0,2196720,0
fc015,2KPY311189,20191001_20191031,temp,0,0,0,549198,0
fc016,2KNY3111MV,20191001_20191031,acc,0,0,0,62900,0
fc016,2KNY3111MV,20191001_20191031,eda,0,0,0,7917,0
fc016,2KNY3111MV,20191001_20191031,temp,0,0,0,1980,0
fc017,2KPY31118Q,20191001_20191031,acc,0,0,0,1591380,0
fc017,2KPY31118Q,20191001_20191031,eda,0,0,0,200122,0
fc017,2KPY31118Q,20191001_20191031,temp,0,0,0,50030,0
fc018,2KNY3111YR,20191001_20191031,acc,0,0,0,514450,0
fc018,2KNY3111YR,20191001_20191031,eda,0,0,0,64727,0
fc018,2KNY3111YR,20191001_20191031,temp,0,0,0,16180,0
fc019,2KPY31118N,20191001_20191031,acc,0,0,0,255230,0
fc019,2KPY31118N,20191001_20191031,eda,0,0,0,31876,0
fc019,2KPY31118N,20191001_20191031,temp,0,0,0,7965,0
fc020,2KPY31117R,20191001_20191031,acc,0,0,0,1797470,0
fc020,2KPY31117R,20191001_20191031,eda,0,0,0,226850,0
fc020,2KPY31117R,20191001_20191031,temp,0,0,0,56710,0
fc021,2KPY31117P,20191001_20191031,acc,0,0,0,1264500,0
fc021,2KPY31117P,20191001_20191031,eda,0,0,0,158483,0
fc021,2KPY31117P,20191001_20191031,temp,0,0,0,39620,0
mgh016,2KNY31121Q,20191001_20191031,acc,0,0,0,45428518,0
mgh016,2KNY31121Q,20191001_20191031,eda,0,0,0,5550811,0
mgh016,2KNY31121Q,20191001_20191031,temp,0,0,0,1387754,0
mgh026,2KPY31116L,20191001_20191031,acc,0,0,0,56820634,0
mgh026,2KPY31116L,20191001_20191031,eda,0,0,0,6972591,0
mgh026,2KPY31116L,20191001_20191031,temp,0,0,0,1743198,0
mgh027,2KPY311188,20191001_20191031,acc,0,0,0,82095098,0
mgh027,2KPY311188,20191001_20191031,eda,0,0,0,10102832,0
mgh027,2KPY311188,20191001_20191031,temp,0,0,0,2525786,0
mgh029,2KPY31117Y,20191001_20191031,acc,0,0,0,82216746,0
mgh029,2KPY31117Y,20191001_20191031,eda,0,0,0,10252961,0
mgh029,2KPY31117Y,20191001_20191031,temp,0,0,0,2563301,0
mgh032,2KPY31117T,20191001_20191031,acc,0,0,0,66977037,0
mgh032,2KPY31117T,20191001_20191031,eda,0,0,0,8337340,0
mgh032,2KPY31117T,20191001_20191031,temp,0,0,0,2084389,0
mgh042,2KNY3111LM,20191001_20191031,acc,0,0,0,3916740,0
mgh042,2KNY3111LM,20191001_20191031,eda,0,0,0,493584,0
mgh042,2KNY3111LM,20191001_20191031,temp,0,0,0,123395,0
mgh043,2KPY31117J,20191001_20191031,acc,0,0,0,25838840,0
mgh043,2KPY31117J,20191001_20191031,eda,0,0,0,3216122,0
mgh043,2KPY31117J,20191001_20191031,temp,0,0,0,804050,0
mgh046,2KNY3111XG,20191001_20191031,acc,0,0,0,33096951,0
mgh046,2KNY3111XG,20191001_20191031,eda,0,0,0,4139956,0
mgh046,2KNY3111XG,20191001_20191031,temp,0,0,0,1035026,0
mgh053,2KPY31118J,20191001_20191031,acc,0,0,0,19776450,0
mgh053,2KPY31118J,20191001_20191031,eda,0,0,0,2489227,0
mgh053,2KPY31118J,20191001_20191031,temp,0,0,0,622315,0
mgh054,2KPY311184,20191001_20191031,acc,0,0,10,26889420,10
mgh054,2KPY311184,20191001_20191031,eda,0,0,0,3300505,0
mgh054,2KPY311184,20191001_20191031,temp,0,0,0,825165,0
mgh055,2KNY3111P8,20191001_20191031,acc,0,0,0,59952700,0
mgh055,2KNY3111P8,20191001_20191031,eda,0,0,0,7434271,0
mgh055,2KNY3111P8,20191001_20191031,temp,0,0,0,1858620,0
mgh058,2KPY31118F,20191001_20191031,acc,0,0,0,45994941,0
mgh058,2KPY31118F,20191001_20191031,eda,0,0,0,5688351,0
mgh058,2KPY31118F,20191001_20191031,temp,0,0,0,1422110,0
mgh059,2KNY311211,20191001_20191031,acc,0,0,0,10825670,0
mgh059,2KNY311211,20191001_20191031,eda,0,0,0,1332565,0
mgh059,2KNY311211,20191001_20191031,temp,0,0,0,333160,0
mgh060,2KPY31118L,20191001_20191031,acc,0,0,0,33397110,0
mgh060,2KPY31118L,20191001_20191031,eda,0,0,0,4153604,0
mgh060,2KPY31118L,20191001_20191031,temp,0,0,0,1038435,0
mgh063,2KNY3111X2,20191001_20191031,acc,0,0,0,8024180,0
mgh063,2KNY3111X2,20191001_20191031,eda,0,0,0,1006226,0
mgh063,2KNY3111X2,20191001_20191031,temp,0,0,0,251565,0
mgh064,2KNY311216,20191001_20191031,acc,0,0,0,8454225,0
mgh064,2KNY311216,20191001_20191031,eda,0,0,0,1028392,0
mgh064,2KNY311216,20191001_20191031,temp,0,0,0,257112,0
mgh065,2KNY311221,20191001_20191031,acc,0,0,0,1270030,0
mgh065,2KNY311221,20191001_20191031,eda,0,0,0,156780,0
mgh065,2KNY311221,20191001_20191031,temp,0,0,0,39200,0
mgh066,2KPY311191,20191001_20191031,acc,0,0,0,10935505,0
mgh066,2KPY311191,20191001_20191031,eda,0,0,0,1373800,0
mgh066,2KPY311191,20191001_20191031,temp,0,0,0,343450,0
mgh067,2M4Y4111J5,20191001_20191031,acc,0,0,0,19651490,0
mgh067,2M4Y4111J5,20191001_20191031,eda,0,0,0,2451215,0
mgh067,2M4Y4111J5,20191001_20191031,temp,0,0,0,612830,0
fc002,2KNY3111YJ,20191101_20191130,acc,0,0,0,37432140,0
fc002,2KNY3111YJ,20191101_20191130,eda,0,0,0,4666311,0
fc002,2KNY3111YJ,20191101_20191130,temp,0,0,0,1166615,0
fc003,2KPY31117N,20191101_20191130,acc,0,0,0,39001513,0
fc003,2KPY31117N,20191101_20191130,eda,0,0,0,4815625,0
fc003,2KPY31117N,20191101_20191130,temp,0,0,0,1203932,0
fc009,2KNY3111Y8,20191101_20191130,acc,0,0,0,33503860,0
fc009,2KNY3111Y8,20191101_20191130,eda,0,0,0,4199358,0
fc009,2KNY3111Y8,20191101_20191130,temp,0,0,0,1049869,0
fc010,2KPY311199,20191101_20191130,acc,0,0,0,24391198,0
fc010,2KPY311199,20191101_20191130,eda,0,0,0,3070044,0
fc010,2KPY311199,20191101_20191130,temp,0,0,0,767529,0
fc011,2KNY3111NJ,20191101_20191130,acc,0,0,0,52467882,0
fc011,2KNY3111NJ,20191101_20191130,eda,0,0,0,6500458,0
fc011,2KNY3111NJ,20191101_20191130,temp,0,0,0,1625167,0
fc012,2KPY31118K,20191101_20191130,acc,0,0,0,27142040,0
fc012,2KPY31118K,20191101_20191130,eda,0,0,0,3383302,0
fc012,2KPY31118K,20191101_20191130,temp,0,0,0,845850,0
fc013,2KPY31113R,20191101_20191130,acc,0,0,60,49751895,60
fc013,2KPY31113R,20191101_20191130,eda,0,0,0,6241246,0
fc013,2KPY31113R,20191101_20191130,temp,0,0,0,1560361,0
fc014,2KPY311181,20191101_20191130,acc,0,0,0,9325320,0
fc014,2KPY311181,20191101_20191130,eda,0,0,0,1169792,0
fc014,2KPY311181,20191101_20191130,temp,0,0,0,292460,0
fc015,2KPY311189,20191101_20191130,acc,0,0,0,65269848,0
fc015,2KPY311189,20191101_20191130,eda,0,0,0,8204303,0
fc015,2KPY311189,20191101_20191130,temp,0,0,0,2051136,0
fc020,2KPY31117R,20191101_20191130,acc,0,0,0,3289020,0
fc020,2KPY31117R,20191101_20191130,eda,0,0,0,417937,0
fc020,2KPY31117R,20191101_20191130,temp,0,0,0,104485,0
fc022,2KPY311183,20191101_20191130,acc,0,0,0,15126620,0
fc022,2KPY311183,20191101_20191130,eda,0,0,0,1857388,0
fc022,2KPY311183,20191101_20191130,temp,0,0,0,464355,0
fc023,2KPY31111R,20191101_20191130,acc,0,0,0,61140,0
fc023,2KPY31111R,20191101_20191130,eda,0,0,0,7553,0
fc023,2KPY31111R,20191101_20191130,temp,0,0,0,1885,0
fc026,2M4Y4111JP,20191101_20191130,acc,0,0,0,5666190,0
fc026,2M4Y4111JP,20191101_20191130,eda,0,0,0,712361,0
fc026,2M4Y4111JP,20191101_20191130,temp,0,0,0,178100,0
fc028,2M4Y4111G5,20191101_20191130,acc,0,0,0,338970,0
fc028,2M4Y4111G5,20191101_20191130,eda,0,0,0,42627,0
fc028,2M4Y4111G5,20191101_20191130,temp,0,0,0,10655,0
mgh016,2KNY31121Q,20191101_20191130,acc,0,0,0,12217279,0
mgh016,2KNY31121Q,20191101_20191130,eda,0,0,0,1492949,0
mgh016,2KNY31121Q,20191101_20191130,temp,0,0,0,373255,0
mgh026,2KPY31116L,20191101_20191130,acc,0,0,0,15943870,0
mgh026,2KPY31116L,20191101_20191130,eda,0,0,0,1956708,0
mgh026,2KPY31116L,20191101_20191130,temp,0,0,0,489195,0
mgh027,2KPY311188,20191101_20191130,acc,0,0,0,68967213,0
mgh027,2KPY311188,20191101_20191130,eda,0,0,0,8483721,0
mgh027,2KPY311188,20191101_20191130,temp,0,0,0,2120994,0
mgh029,2KPY31117Y,20191101_20191130,acc,0,0,0,78983838,0
mgh029,2KPY31117Y,20191101_20191130,eda,0,0,0,9869808,0
mgh029,2KPY31117Y,20191101_20191130,temp,0,0,0,2467517,0
mgh030,2KNY3111L9,20191101_20191130,acc,0,0,0,25341702,0
mgh030,2KNY3111L9,20191101_20191130,eda,0,0,0,3152102,0
mgh030,2KNY3111L9,20191101_20191130,temp,0,0,0,788052,0
mgh032,2KPY31117T,20191101_20191130,acc,0,0,0,61268787,0
mgh032,2KPY31117T,20191101_20191130,eda,0,0,0,7625687,0
mgh032,2KPY31117T,20191101_20191130,temp,0,0,0,1906460,0
mgh053,2KPY31118J,20191101_20191130,acc,0,0,0,32362340,0
mgh053,2KPY31118J,20191101_20191130,eda,0,0,0,4092580,0
mgh053,2KPY31118J,20191101_20191130,temp,0,0,0,1023166,0
mgh055,2KNY3111P8,20191101_20191130,acc,0,0,0,22922083,0
mgh055,2KNY3111P8,20191101_20191130,eda,0,0,0,2854323,0
mgh055,2KNY3111P8,20191101_20191130,temp,0,0,0,713597,0
mgh058,2KPY31118F,20191101_20191130,acc,0,0,0,70042465,0
mgh058,2KPY31118F,20191101_20191130,eda,0,0,0,8671814,0
mgh058,2KPY31118F,20191101_20191130,temp,0,0,0,2168013,0
mgh060,2KPY31118L,20191101_20191130,acc,0,0,0,59942187,0
mgh060,2KPY31118L,20191101_20191130,eda,0,0,0,7444091,0
mgh060,2KPY31118L,20191101_20191130,temp,0,0,0,1861088,0
mgh063,2KNY3111X2,20191101_20191130,acc,0,0,0,41039038,0
mgh063,2KNY3111X2,20191101_20191130,eda,0,0,0,5134948,0
mgh063,2KNY3111X2,20191101_20191130,temp,0,0,0,1283765,0
mgh064,2KNY311216,20191101_20191130,acc,0,0,0,585732,0
mgh064,2KNY311216,20191101_20191130,eda,0,0,0,71326,0
mgh064,2KNY311216,20191101_20191130,temp,0,0,0,17832,0
mgh066,2KPY311191,20191101_20191130,acc,0,0,0,2502593,0
mgh066,2KPY311191,20191101_20191130,eda,0,0,0,315104,0
mgh066,2KPY311191,20191101_20191130,temp,0,0,0,78779,0
mgh067,2M4Y4111J5,20191101_20191130,acc,0,0,0,56586620,0
mgh067,2M4Y4111J5,20191101_20191130,eda,0,0,0,7068243,0
mgh067,2M4Y4111J5,20191101_20191130,temp,0,0,0,1767105,0
mgh069,2KPY31117L,20191101_20191130,acc,0,0,0,49059990,0
mgh069,2KPY31117L,20191101_20191130,eda,0,0,0,6059170,0
mgh069,2KPY31117L,20191101_20191130,temp,0,0,0,1514855,0
mgh070,2M4Y4111H7,20191101_20191130,acc,0,0,0,31994710,0
mgh070,2M4Y4111H7,20191101_20191130,eda,0,0,0,3933631,0
mgh070,2M4Y4111H7,20191101_20191130,temp,0,0,0,983450,0
mgh071,2M4Y4111H9,20191101_20191130,acc,0,0,0,24797261,0
mgh071,2M4Y4111H9,20191101_20191130,eda,0,0,0,3080196,0
mgh071,2M4Y4111H9,20191101_20191130,temp,0,0,0,770082,0
fc002,2KNY3111YJ,20191201_20191231,acc,0,0,0,21332770,0
fc002,2KNY3111YJ,20191201_20191231,eda,0,0,0,2656381,0
fc002,2KNY3111YJ,20191201_20191231,temp,0,0,0,664110,0
fc003,2KPY31117N,20191201_20191231,acc,0,0,0,29922434,0
fc003,2KPY31117N,20191201_20191231,eda,0,0,0,3690193,0
fc003,2KPY31117N,20191201_20191231,temp,0,0,0,922582,0
fc009,2KNY3111Y8,20191201_20191231,acc,0,0,0,23936880,0
fc009,2KNY3111Y8,20191201_20191231,eda,0,0,0,3000647,0
fc009,2KNY3111Y8,20191201_20191231,temp,0,0,0,750175,0
fc010,2KPY311199,20191201_20191231,acc,0,0,0,27128520,0
fc010,2KPY311199,20191201_20191231,eda,0,0,0,3415243,0
fc010,2KPY311199,20191201_20191231,temp,0,0,0,853880,0
fc011,2KNY3111NJ,20191201_20191231,acc,0,0,0,46951459,0
fc011,2KNY3111NJ,20191201_20191231,eda,0,0,0,5815390,0
fc011,2KNY3111NJ,20191201_20191231,temp,0,0,0,1453883,0
fc013,2KPY31113R,20191201_20191231,acc,0,0,0,16576754,0
fc013,2KPY31113R,20191201_20191231,eda,0,0,0,2082123,0
fc013,2KPY31113R,20191201_20191231,temp,0,0,0,520546,0
fc015,2KPY311189,20191201_20191231,acc,0,0,12,65132315,12
fc015,2KPY311189,20191201_20191231,eda,0,0,0,8189568,0
fc015,2KPY311189,20191201_20191231,temp,0,0,0,2047439,0
fc019,2KPY31118N,20191201_20191231,acc,0,0,0,59293382,0
fc019,2KPY31118N,20191201_20191231,eda,0,0,0,7331864,0
fc019,2KPY31118N,20191201_20191231,temp,0,0,0,1833013,0
fc022,2KPY311183,20191201_20191231,acc,0,0,0,23994620,0
fc022,2KPY311183,20191201_20191231,eda,0,0,0,2946827,0
fc022,2KPY311183,20191201_20191231,temp,0,0,0,736720,0
fc023,2KPY31111R,20191201_20191231,acc,0,0,14,68542708,14
fc023,2KPY31111R,20191201_20191231,eda,0,0,0,8400535,0
fc023,2KPY31111R,20191201_20191231,temp,0,0,0,2100182,0
fc025,2M4Y41122K,20191201_20191231,acc,0,0,0,47605450,0
fc025,2M4Y41122K,20191201_20191231,eda,0,0,0,5887011,0
fc025,2M4Y41122K,20191201_20191231,temp,0,0,0,1471785,0
fc030,2M5Y41111N,20191201_20191231,acc,0,0,0,19445780,0
fc030,2M5Y41111N,20191201_20191231,eda,0,0,0,2375451,0
fc030,2M5Y41111N,20191201_20191231,temp,0,0,0,593880,0
fc031,2M4Y4111J1,20191201_20191231,acc,0,0,0,6960010,0
fc031,2M4Y4111J1,20191201_20191231,eda,0,0,0,863395,0
fc031,2M4Y4111J1,20191201_20191231,temp,0,0,0,215850,0
fc032,2M4Y4111DT,20191201_20191231,acc,0,0,0,22310375,0
fc032,2M4Y4111DT,20191201_20191231,eda,0,0,0,2778341,0
fc032,2M4Y4111DT,20191201_20191231,temp,0,0,0,694605,0
fc033,2M4Y4111J2,20191201_20191231,acc,0,0,0,32070,0
fc033,2M4Y4111J2,20191201_20191231,eda,0,0,0,4030,0
fc033,2M4Y4111J2,20191201_20191231,temp,0,0,0,1010,0
fc034,2M5Y411123,20191201_20191231,acc,0,0,0,35362671,0
fc034,2M5Y411123,20191201_20191231,eda,0,0,0,4388616,0
fc034,2M5Y411123,20191201_20191231,temp,0,0,0,1097193,0
fc035,2M4Y4111FT,20191201_20191231,acc,0,0,0,124100,0
fc035,2M4Y4111FT,20191201_20191231,eda,0,0,0,15652,0
fc035,2M4Y4111FT,20191201_20191231,temp,0,0,0,3910,0
fc037,2M4Y4111GH,20191201_20191231,acc,0,0,0,818030,0
fc037,2M4Y4111GH,20191201_20191231,eda,0,0,0,104091,0
fc037,2M4Y4111GH,20191201_20191231,temp,0,0,0,26020,0
fc038,2M4Y41122G,20191201_20191231,acc,0,0,0,914090,0
fc038,2M4Y41122G,20191201_20191231,eda,0,0,0,115128,0
fc038,2M4Y41122G,20191201_20191231,temp,0,0,0,28780,0
fc039,2M4Y4111HM,20191201_20191231,acc,0,0,0,4721180,0
fc039,2M4Y4111HM,20191201_20191231,eda,0,0,0,599417,0
fc039,2M4Y4111HM,20191201_20191231,temp,0,0,0,149855,0
fc040,2M4Y4111J7,20191201_20191231,acc,0,0,0,1104530,0
fc040,2M4Y4111J7,20191201_20191231,eda,0,0,0,137449,0
fc040,2M4Y4111J7,20191201_20191231,temp,0,0,0,34360,0
mgh029,2KPY31117Y,20191201_20191231,acc,0,0,0,8579830,0
mgh029,2KPY31117Y,20191201_20191231,eda,0,0,0,1071744,0
mgh029,2KPY31117Y,20191201_20191231,temp,0,0,0,267947,0
mgh030,2KNY3111L9,20191201_20191231,acc,0,0,0,10717086,0
mgh030,2KNY3111L9,20191201_20191231,eda,0,0,0,1331646,0
mgh030,2KNY3111L9,20191201_20191231,temp,0,0,0,332922,0
mgh032,2KPY31117T,20191201_20191231,acc,0,0,0,24135250,0
mgh032,2KPY31117T,20191201_20191231,eda,0,0,0,3001362,0
mgh032,2KPY31117T,20191201_20191231,temp,0,0,0,750365,0
mgh053,2KPY31118J,20191201_20191231,acc,0,0,0,12554179,0
mgh053,2KPY31118J,20191201_20191231,eda,0,0,0,1581318,0
mgh053,2KPY31118J,20191201_20191231,temp,0,0,0,395343,0
mgh055,2KNY3111P8,20191201_20191231,acc,0,0,0,32701625,0
mgh055,2KNY3111P8,20191201_20191231,eda,0,0,0,4057474,0
mgh055,2KNY3111P8,20191201_20191231,temp,0,0,0,1014392,0
mgh058,2KPY31118F,20191201_20191231,acc,0,0,0,61339779,0
mgh058,2KPY31118F,20191201_20191231,eda,0,0,0,7594058,0
mgh058,2KPY31118F,20191201_20191231,temp,0,0,0,1898570,0
mgh059,2KNY311211,20191201_20191231,acc,0,0,0,5268870,0
mgh059,2KNY311211,20191201_20191231,eda,0,0,0,656071,0
mgh059,2KNY311211,20191201_20191231,temp,0,0,0,164025,0
mgh060,2KPY31118L,20191201_20191231,acc,0,0,0,61853561,0
mgh060,2KPY31118L,20191201_20191231,eda,0,0,0,7705756,0
mgh060,2KPY31118L,20191201_20191231,temp,0,0,0,1926489,0
mgh062,2M4Y4111JF,20191201_20191231,acc,0,0,0,4246930,0
mgh062,2M4Y4111JF,20191201_20191231,eda,0,0,0,527631,0
mgh062,2M4Y4111JF,20191201_20191231,temp,0,0,0,131915,0
mgh063,2KNY3111X2,20191201_20191231,acc,0,0,0,27496318,0
mgh063,2KNY3111X2,20191201_20191231,eda,0,0,0,3443459,0
mgh063,2KNY3111X2,20191201_20191231,temp,0,0,0,860888,0
mgh064,2KNY311216,20191201_20191231,acc,0,0,0,75911608,0
mgh064,2KNY311216,20191201_20191231,eda,0,0,0,9234719,0
mgh064,2KNY311216,20191201_20191231,temp,0,0,0,2308734,0
mgh067,2M4Y4111J5,20191201_20191231,acc,0,0,0,69978781,0
mgh067,2M4Y4111J5,20191201_20191231,eda,0,0,0,8723936,0
mgh067,2M4Y4111J5,20191201_20191231,temp,0,0,0,2181035,0
mgh069,2KPY31117L,20191201_20191231,acc,0,0,0,66963733,0
mgh069,2KPY31117L,20191201_20191231,eda,0,0,0,8265335,0
mgh069,2KPY31117L,20191201_20191231,temp,0,0,0,2066405,0
mgh071,2M4Y4111H9,20191201_20191231,acc,0,0,0,72175624,0
mgh071,2M4Y4111H9,20191201_20191231,eda,0,0,0,8965818,0
mgh071,2M4Y4111H9,20191201_20191231,temp,0,0,0,2241509,0
mgh073,2M4Y4111HX,20191201_20191231,acc,0,0,0,4805750,0
mgh073,2M4Y4111HX,20191201_20191231,eda,0,0,0,609050,0
mgh073,2M4Y4111HX,20191201_20191231,temp,0,0,0,152270,0
mgh075,2KNY311227,20191201_20191231,acc,0,0,0,48076213,0
mgh075,2KNY311227,20191201_20191231,eda,0,0,0,5988828,0
mgh075,2KNY311227,20191201_20191231,temp,0,0,0,1497260,0
mgh076,2M4Y4111F7,20191201_20191231,acc,0,0,0,22336701,0
mgh076,2M4Y4111F7,20191201_20191231,eda,0,0,0,2792289,0
mgh076,2M4Y4111F7,20191201_20191231,temp,0,0,0,698096,0
mgh077,2M4Y4111GD,20191201_20191231,acc,0,0,0,2909840,0
mgh077,2M4Y4111GD,20191201_20191231,eda,0,0,0,361049,0
mgh077,2M4Y4111GD,20191201_20191231,temp,0,0,0,90265,0
mgh079,2M4Y4111GM,20191201_20191231,acc,0,0,0,22459240,0
mgh079,2M4Y4111GM,20191201_20191231,eda,0,0,0,2811406,0
mgh079,2M4Y4111GM,20191201_20191231,temp,0,0,0,702880,0
fc002,2KNY3111YJ,20200101_20200131,acc,0,0,0,22410720,0
fc002,2KNY3111YJ,20200101_20200131,eda,0,0,0,2799914,0
fc002,2KNY3111YJ,20200101_20200131,temp,0,0,0,699990,0
fc009,2KNY3111Y8,20200101_20200131,acc,0,0,0,13704950,0
fc009,2KNY3111Y8,20200101_20200131,eda,0,0,0,1718132,0
fc009,2KNY3111Y8,20200101_20200131,temp,0,0,0,429545,0
fc010,2KPY311199,20200101_20200131,acc,0,0,0,4283360,0
fc010,2KPY311199,20200101_20200131,eda,0,0,0,536016,0
fc010,2KPY311199,20200101_20200131,temp,0,0,0,134010,0
fc013,2KPY31113R,20200101_20200131,acc,0,0,0,6644950,0
fc013,2KPY31113R,20200101_20200131,eda,0,0,0,832247,0
fc013,2KPY31113R,20200101_20200131,temp,0,0,0,208065,0
fc015,2KPY311189,20200101_20200131,acc,0,0,0,53367083,0
fc015,2KPY311189,20200101_20200131,eda,0,0,0,6718503,0
fc015,2KPY311189,20200101_20200131,temp,0,0,0,1679680,0
fc019,2KPY31118N,20200101_20200131,acc,0,0,0,83747663,0
fc019,2KPY31118N,20200101_20200131,eda,0,0,0,10363228,0
fc019,2KPY31118N,20200101_20200131,temp,0,0,0,2590869,0
fc020,2KPY31117R,20200101_20200131,acc,0,0,0,26337940,0
fc020,2KPY31117R,20200101_20200131,eda,0,0,0,3286621,0
fc020,2KPY31117R,20200101_20200131,temp,0,0,0,821680,0
fc022,2KPY311183,20200101_20200131,acc,0,0,0,6044320,0
fc022,2KPY311183,20200101_20200131,eda,0,0,0,743184,0
fc022,2KPY311183,20200101_20200131,temp,0,0,0,185800,0
fc023,2KPY31111R,20200101_20200131,acc,0,0,738,80862269,738
fc023,2KPY31111R,20200101_20200131,eda,0,0,0,9911357,0
fc023,2KPY31111R,20200101_20200131,temp,0,0,0,2477917,0
fc026,2M4Y4111JP,20200101_20200131,acc,0,0,0,4356370,0
fc026,2M4Y4111JP,20200101_20200131,eda,0,0,0,550485,0
fc026,2M4Y4111JP,20200101_20200131,temp,0,0,0,137622,0
fc028,2M4Y4111G5,20200101_20200131,acc,0,0,0,6508830,0
fc028,2M4Y4111G5,20200101_20200131,eda,0,0,0,818324,0
fc028,2M4Y4111G5,20200101_20200131,temp,0,0,0,204585,0
fc030,2M5Y41111N,20200101_20200131,acc,0,0,0,66602620,0
fc030,2M5Y41111N,20200101_20200131,eda,0,0,0,8132610,0
fc030,2M5Y41111N,20200101_20200131,temp,0,0,0,2033217,0
fc031,2M4Y4111J1,20200101_20200131,acc,0,0,0,7782692,0
fc031,2M4Y4111J1,20200101_20200131,eda,0,0,0,970138,0
fc031,2M4Y4111J1,20200101_20200131,temp,0,0,0,242543,0
fc032,2M4Y4111DT,20200101_20200131,acc,0,0,0,63945743,0
fc032,2M4Y4111DT,20200101_20200131,eda,0,0,0,7964868,0
fc032,2M4Y4111DT,20200101_20200131,temp,0,0,0,1991269,0
fc034,2M5Y411123,20200101_20200131,acc,0,0,0,27954746,0
fc034,2M5Y411123,20200101_20200131,eda,0,0,0,3487599,0
fc034,2M5Y411123,20200101_20200131,temp,0,0,0,871926,0
fc035,2M4Y4111FT,20200101_20200131,acc,0,0,0,27378720,0
fc035,2M4Y4111FT,20200101_20200131,eda,0,0,0,3428750,0
fc035,2M4Y4111FT,20200101_20200131,temp,0,0,0,857220,0
fc037,2M4Y4111GH,20200101_20200131,acc,0,0,4,42330261,4
fc037,2M4Y4111GH,20200101_20200131,eda,0,0,0,5316304,0
fc037,2M4Y4111GH,20200101_20200131,temp,0,0,0,1329111,0
fc039,2M4Y4111HM,20200101_20200131,acc,0,0,0,39217990,0
fc039,2M4Y4111HM,20200101_20200131,eda,0,0,0,4930042,0
fc039,2M4Y4111HM,20200101_20200131,temp,0,0,0,1232540,0
fc040,2M4Y4111J7,20200101_20200131,acc,0,0,0,14115670,0
fc040,2M4Y4111J7,20200101_20200131,eda,0,0,0,1739868,0
fc040,2M4Y4111J7,20200101_20200131,temp,0,0,0,434975,0
fc041,2M4Y4111JM,20200101_20200131,acc,0,0,0,1069750,0
fc041,2M4Y4111JM,20200101_20200131,eda,0,0,0,132288,0
fc041,2M4Y4111JM,20200101_20200131,temp,0,0,0,33070,0
fc042,2M4Y4111HR,20200101_20200131,acc,0,0,0,2390590,0
fc042,2M4Y4111HR,20200101_20200131,eda,0,0,0,296907,0
fc042,2M4Y4111HR,20200101_20200131,temp,0,0,0,74230,0
fc043,2M4Y4111H3,20200101_20200131,acc,0,0,0,3304894,0
fc043,2M4Y4111H3,20200101_20200131,eda,0,0,0,407673,0
fc043,2M4Y4111H3,20200101_20200131,temp,0,0,0,101920,0
fc044,2M4Y4111GW,20200101_20200131,acc,0,0,0,2203530,0
fc044,2M4Y4111GW,20200101_20200131,eda,0,0,0,273104,0
fc044,2M4Y4111GW,20200101_20200131,temp,0,0,0,68270,0
fc045,2M4Y4111FK,20200101_20200131,acc,0,0,0,19282361,0
fc045,2M4Y4111FK,20200101_20200131,eda,0,0,0,2412011,0
fc045,2M4Y4111FK,20200101_20200131,temp,0,0,0,603027,0
fc046,2M4Y4111HG,20200101_20200131,acc,0,0,0,6788270,0
fc046,2M4Y4111HG,20200101_20200131,eda,0,0,0,850239,0
fc046,2M4Y4111HG,20200101_20200131,temp,0,0,0,212565,0
fc047,2M4Y4111FM,20200101_20200131,acc,0,0,0,5180890,0
fc047,2M4Y4111FM,20200101_20200131,eda,0,0,0,644397,0
fc047,2M4Y4111FM,20200101_20200131,temp,0,0,0,161095,0
fc049,2M4Y4111JH,20200101_20200131,acc,0,0,0,2061490,0
fc049,2M4Y4111JH,20200101_20200131,eda,0,0,0,258453,0
fc049,2M4Y4111JH,20200101_20200131,temp,0,0,0,64615,0
fc050,2M4Y41123K,20200101_20200131,acc,0,0,0,747460,0
fc050,2M4Y41123K,20200101_20200131,eda,0,0,0,94081,0
fc050,2M4Y41123K,20200101_20200131,temp,0,0,0,23520,0
fc051,2M4Y4111FD,20200101_20200131,acc,0,0,0,2243980,0
fc051,2M4Y4111FD,20200101_20200131,eda,0,0,0,282490,0
fc051,2M4Y4111FD,20200101_20200131,temp,0,0,0,70620,0
mgh053,2KPY31118J,20200101_20200131,acc,0,0,0,1033640,0
mgh053,2KPY31118J,20200101_20200131,eda,0,0,0,130481,0
mgh053,2KPY31118J,20200101_20200131,temp,0,0,0,32620,0
mgh055,2KNY3111P8,20200101_20200131,acc,0,0,0,6284910,0
mgh055,2KNY3111P8,20200101_20200131,eda,0,0,0,777840,0
mgh055,2KNY3111P8,20200101_20200131,temp,0,0,0,194468,0
mgh058,2KPY31118F,20200101_20200131,acc,0,0,0,28612676,0
mgh058,2KPY31118F,20200101_20200131,eda,0,0,0,3535121,0
mgh058,2KPY31118F,20200101_20200131,temp,5,0,1,883789,6
mgh060,2KPY31118L,20200101_20200131,acc,0,0,0,32551856,0
mgh060,2KPY31118L,20200101_20200131,eda,0,0,0,4038444,0
mgh060,2KPY31118L,20200101_20200131,temp,0,0,0,1009606,0
mgh063,2KNY3111X2,20200101_20200131,acc,0,0,0,28844388,0
mgh063,2KNY3111X2,20200101_20200131,eda,0,0,0,3612251,0
mgh063,2KNY3111X2,20200101_20200131,temp,0,0,0,903086,0
mgh064,2KNY311216,20200101_20200131,acc,0,0,0,80974794,0
mgh064,2KNY311216,20200101_20200131,eda,0,0,0,9851031,0
mgh064,2KNY311216,20200101_20200131,temp,0,0,0,2462833,0
mgh067,2M4Y4111J5,20200101_20200131,acc,0,0,0,19424724,0
mgh067,2M4Y4111J5,20200101_20200131,eda,0,0,0,2429939,0
mgh067,2M4Y4111J5,20200101_20200131,temp,0,0,0,607513,0
mgh069,2KPY31117L,20200101_20200131,acc,0,0,0,56128345,0
mgh069,2KPY31117L,20200101_20200131,eda,0,0,0,6932142,0
mgh069,2KPY31117L,20200101_20200131,temp,0,0,0,1733084,0
mgh071,2M4Y4111H9,20200101_20200131,acc,0,0,0,66863300,0
mgh071,2M4Y4111H9,20200101_20200131,eda,0,0,0,8302696,0
mgh071,2M4Y4111H9,20200101_20200131,temp,0,0,0,2075732,0
mgh075,2KNY311227,20200101_20200131,acc,0,0,0,64419587,0
mgh075,2KNY311227,20200101_20200131,eda,0,0,0,8049529,0
mgh075,2KNY311227,20200101_20200131,temp,6,0,0,2012435,6
mgh076,2M4Y4111F7,20200101_20200131,acc,0,0,0,32445367,0
mgh076,2M4Y4111F7,20200101_20200131,eda,0,0,0,4067183,0
mgh076,2M4Y4111F7,20200101_20200131,temp,0,0,0,1016823,0
mgh078,2M4Y411134,20200101_20200131,acc,0,0,28,62429115,28
mgh078,2M4Y411134,20200101_20200131,eda,0,0,2,7757216,2
mgh078,2M4Y411134,20200101_20200131,temp,0,0,2,1939372,2
mgh079,2M4Y4111GM,20200101_20200131,acc,0,0,0,19784695,0
mgh079,2M4Y4111GM,20200101_20200131,eda,0,0,0,2476198,0
mgh079,2M4Y4111GM,20200101_20200131,temp,0,0,0,619065,0
mgh080,2M4Y4111FV,20200101_20200131,acc,0,0,0,5506660,0
mgh080,2M4Y4111FV,20200101_20200131,eda,0,0,0,668213,0
mgh080,2M4Y4111FV,20200101_20200131,temp,0,0,0,167060,0
mgh081,2M4Y4111J3,20200101_20200131,acc,0,0,0,27158949,0
mgh081,2M4Y4111J3,20200101_20200131,eda,0,0,0,3397028,0
mgh081,2M4Y4111J3,20200101_20200131,temp,0,0,0,849276,0
mgh082,2M4Y4111DQ,20200101_20200131,acc,0,0,0,13486140,0
mgh082,2M4Y4111DQ,20200101_20200131,eda,0,0,0,1689077,0
mgh082,2M4Y4111DQ,20200101_20200131,temp,0,0,0,422285,0
mgh083,2M4Y4111G3,20200101_20200131,acc,0,0,0,1770130,0
mgh083,2M4Y4111G3,20200101_20200131,eda,0,0,0,221143,0
mgh083,2M4Y4111G3,20200101_20200131,temp,0,0,0,55295,0
mgh084,2M4Y4111HT,20200101_20200131,acc,0,0,0,10551940,0
mgh084,2M4Y4111HT,20200101_20200131,eda,0,0,0,1310166,0
mgh084,2M4Y4111HT,20200101_20200131,temp,0,0,0,327555,0
mgh085,2M4Y4111RV,20200101_20200131,acc,0,0,0,2560550,0
mgh085,2M4Y4111RV,20200101_20200131,eda,0,0,0,318123,0
mgh085,2M4Y4111RV,20200101_20200131,temp,0,0,0,79535,0
mgh087,2M4Y4111R8,20200101_20200131,acc,0,0,0,6170370,0
mgh087,2M4Y4111R8,20200101_20200131,eda,0,0,0,760760,0
mgh087,2M4Y4111R8,20200101_20200131,temp,0,0,0,190195,0
fc010,2KPY311199,20200201_20200229,acc,0,0,0,4141720,0
fc010,2KPY311199,20200201_20200229,eda,0,0,0,518258,0
fc010,2KPY311199,20200201_20200229,temp,0,0,0,129565,0
fc011,2KNY3111NJ,20200201_20200229,acc,0,0,0,5023180,0
fc011,2KNY3111NJ,20200201_20200229,eda,0,0,0,622921,0
fc011,2KNY3111NJ,20200201_20200229,temp,0,0,0,155735,0
fc013,2KPY31113R,20200201_20200229,acc,0,0,0,14813520,0
fc013,2KPY31113R,20200201_20200229,eda,0,0,0,1854385,0
fc013,2KPY31113R,20200201_20200229,temp,0,0,0,463605,0
fc015,2KPY311189,20200201_20200229,acc,0,0,0,53253547,0
fc015,2KPY311189,20200201_20200229,eda,0,0,0,6694162,0
fc015,2KPY311189,20200201_20200229,temp,0,0,0,1673580,0
fc019,2KPY31118N,20200201_20200229,acc,0,0,0,75134710,0
fc019,2KPY31118N,20200201_20200229,eda,0,0,0,9294505,0
fc019,2KPY31118N,20200201_20200229,temp,0,0,0,2323699,0
fc020,2KPY31117R,20200201_20200229,acc,0,0,0,26327180,0
fc020,2KPY31117R,20200201_20200229,eda,0,0,0,3288337,0
fc020,2KPY31117R,20200201_20200229,temp,0,0,0,822110,0
fc023,2KPY31111R,20200201_20200229,acc,0,0,0,50082379,0
fc023,2KPY31111R,20200201_20200229,eda,0,0,0,6142491,0
fc023,2KPY31111R,20200201_20200229,temp,0,0,0,1535659,0
fc026,2M4Y4111JP,20200201_20200229,acc,0,0,0,64178682,0
fc026,2M4Y4111JP,20200201_20200229,eda,0,0,0,7981561,0
fc026,2M4Y4111JP,20200201_20200229,temp,0,0,0,1995449,0
fc030,2M5Y41111N,20200201_20200229,acc,0,0,0,44245587,0
fc030,2M5Y41111N,20200201_20200229,eda,0,0,0,5417598,0
fc030,2M5Y41111N,20200201_20200229,temp,0,0,0,1354442,0
fc032,2M4Y4111DT,20200201_20200229,acc,0,0,0,19501390,0
fc032,2M4Y4111DT,20200201_20200229,eda,0,0,0,2428439,0
fc032,2M4Y4111DT,20200201_20200229,temp,0,0,0,607125,0
fc034,2M5Y411123,20200201_20200229,acc,0,0,0,26313040,0
fc034,2M5Y411123,20200201_20200229,eda,0,0,0,3289117,0
fc034,2M5Y411123,20200201_20200229,temp,0,0,0,822305,0
fc035,2M4Y4111FT,20200201_20200229,acc,0,0,0,47996260,0
fc035,2M4Y4111FT,20200201_20200229,eda,0,0,0,6015334,0
fc035,2M4Y4111FT,20200201_20200229,temp,0,0,0,1503875,0
fc037,2M4Y4111GH,20200201_20200229,acc,0,0,0,13951237,0
fc037,2M4Y4111GH,20200201_20200229,eda,0,0,0,1756914,0
fc037,2M4Y4111GH,20200201_20200229,temp,0,0,0,439233,0
fc039,2M4Y4111HM,20200201_20200229,acc,0,0,0,46069321,0
fc039,2M4Y4111HM,20200201_20200229,eda,0,0,0,5790912,0
fc039,2M4Y4111HM,20200201_20200229,temp,0,0,0,1447772,0
fc040,2M4Y4111J7,20200201_20200229,acc,0,0,0,26170881,0
fc040,2M4Y4111J7,20200201_20200229,eda,0,0,0,3222459,0
fc040,2M4Y4111J7,20200201_20200229,temp,0,0,0,805645,0
fc041,2M4Y4111JM,20200201_20200229,acc,0,0,0,46356826,0
fc041,2M4Y4111JM,20200201_20200229,eda,0,0,0,5670893,0
fc041,2M4Y4111JM,20200201_20200229,temp,0,0,0,1417763,0
fc042,2M4Y4111HR,20200201_20200229,acc,0,0,0,17184396,0
fc042,2M4Y4111HR,20200201_20200229,eda,0,0,0,2105437,0
fc042,2M4Y4111HR,20200201_20200229,temp,0,0,0,526370,0
fc043,2M4Y4111H3,20200201_20200229,acc,0,0,0,63548463,0
fc043,2M4Y4111H3,20200201_20200229,eda,0,0,0,7849351,0
fc043,2M4Y4111H3,20200201_20200229,temp,0,0,0,1962403,0
fc044,2M4Y4111GW,20200201_20200229,acc,0,0,0,32760200,0
fc044,2M4Y4111GW,20200201_20200229,eda,0,0,0,4039893,0
fc044,2M4Y4111GW,20200201_20200229,temp,0,0,0,1010010,0
fc045,2M4Y4111FK,20200201_20200229,acc,0,0,0,24977657,0
fc045,2M4Y4111FK,20200201_20200229,eda,0,0,0,3134851,0
fc045,2M4Y4111FK,20200201_20200229,temp,0,0,0,783732,0
fc046,2M4Y4111HG,20200201_20200229,acc,0,0,0,16140000,0
fc046,2M4Y4111HG,20200201_20200229,eda,0,0,0,2013089,0
fc046,2M4Y4111HG,20200201_20200229,temp,0,0,0,503285,0
fc049,2M4Y4111JH,20200201_20200229,acc,0,0,264,68623201,264
fc049,2M4Y4111JH,20200201_20200229,eda,0,0,10,8461748,10
fc049,2M4Y4111JH,20200201_20200229,temp,0,0,0,2115491,0
fc050,2M4Y41123K,20200201_20200229,acc,0,0,0,18221310,0
fc050,2M4Y41123K,20200201_20200229,eda,0,0,0,2277912,0
fc050,2M4Y41123K,20200201_20200229,temp,0,0,0,569485,0
fc051,2M4Y4111FD,20200201_20200229,acc,0,0,0,28900770,0
fc051,2M4Y4111FD,20200201_20200229,eda,0,0,0,3602313,0
fc051,2M4Y4111FD,20200201_20200229,temp,0,0,0,900590,0
fc053,2M4Y4111GN,20200201_20200229,acc,0,0,0,43486313,0
fc053,2M4Y4111GN,20200201_20200229,eda,0,0,0,5402450,0
fc053,2M4Y4111GN,20200201_20200229,temp,0,0,0,1350640,0
fc055,2M4Y4111QW,20200201_20200229,acc,0,0,0,38591094,0
fc055,2M4Y4111QW,20200201_20200229,eda,0,0,0,4800434,0
fc055,2M4Y4111QW,20200201_20200229,temp,0,0,0,1200139,0
fc056,2M4Y4111YJ,20200201_20200229,acc,0,0,0,2020350,0
fc056,2M4Y4111YJ,20200201_20200229,eda,0,0,0,250640,0
fc056,2M4Y4111YJ,20200201_20200229,temp,0,0,0,62660,0
fc057,2M4Y41114D,20200201_20200229,acc,0,0,0,3428260,0
fc057,2M4Y41114D,20200201_20200229,eda,0,0,0,427843,0
fc057,2M4Y41114D,20200201_20200229,temp,0,0,0,106960,0
fc058,2M4Y4111XM,20200201_20200229,acc,0,0,0,1064590,0
fc058,2M4Y4111XM,20200201_20200229,eda,0,0,0,131274,0
fc058,2M4Y4111XM,20200201_20200229,temp,0,0,0,32820,0
fc059,2M4Y4111RK,20200201_20200229,acc,0,0,0,1139320,0
fc059,2M4Y4111RK,20200201_20200229,eda,0,0,0,143819,0
fc059,2M4Y4111RK,20200201_20200229,temp,0,0,0,35955,0
fc061,2M4Y4111WN,20200201_20200229,acc,0,0,0,1118300,0
fc061,2M4Y4111WN,20200201_20200229,eda,0,0,0,141102,0
fc061,2M4Y4111WN,20200201_20200229,temp,0,0,0,35275,0
mgh055,2KNY3111P8,20200201_20200229,acc,0,0,0,24812987,0
mgh055,2KNY3111P8,20200201_20200229,eda,0,0,0,3069844,0
mgh055,2KNY3111P8,20200201_20200229,temp,0,0,0,767491,0
mgh058,2KPY31118F,20200201_20200229,acc,0,0,0,128090,0
mgh058,2KPY31118F,20200201_20200229,eda,0,0,0,15795,0
mgh058,2KPY31118F,20200201_20200229,temp,0,0,0,3950,0
mgh059,2KNY311211,20200201_20200229,acc,0,0,0,2766285,0
mgh059,2KNY311211,20200201_20200229,eda,0,0,0,342783,0
mgh059,2KNY311211,20200201_20200229,temp,0,0,0,85698,0
mgh060,2KPY31118L,20200201_20200229,acc,0,0,0,6893490,0
mgh060,2KPY31118L,20200201_20200229,eda,0,0,0,856141,0
mgh060,2KPY31118L,20200201_20200229,temp,0,0,0,214030,0
mgh063,2KNY3111X2,20200201_20200229,acc,0,0,0,34138251,0
mgh063,2KNY3111X2,20200201_20200229,eda,0,0,0,4273351,0
mgh063,2KNY3111X2,20200201_20200229,temp,0,0,0,1068369,0
mgh064,2KNY311216,20200201_20200229,acc,0,0,0,68450026,0
mgh064,2KNY311216,20200201_20200229,eda,0,0,0,8329817,0
mgh064,2KNY311216,20200201_20200229,temp,0,0,0,2082503,0
mgh067,2M4Y4111J5,20200201_20200229,acc,0,0,0,47819908,0
mgh067,2M4Y4111J5,20200201_20200229,eda,0,0,0,5980495,0
mgh067,2M4Y4111J5,20200201_20200229,temp,0,0,0,1495174,0
mgh069,2KPY31117L,20200201_20200229,acc,0,0,0,31962700,0
mgh069,2KPY31117L,20200201_20200229,eda,0,0,0,3949660,0
mgh069,2KPY31117L,20200201_20200229,temp,0,0,0,987420,0
mgh071,2M4Y4111H9,20200201_20200229,acc,0,0,0,58769623,0
mgh071,2M4Y4111H9,20200201_20200229,eda,0,0,0,7297461,0
mgh071,2M4Y4111H9,20200201_20200229,temp,0,0,0,1824419,0
mgh075,2KNY311227,20200201_20200229,acc,0,0,0,62730356,0
mgh075,2KNY311227,20200201_20200229,eda,0,0,0,7847850,0
mgh075,2KNY311227,20200201_20200229,temp,0,0,0,1962023,0
mgh078,2M4Y411134,20200201_20200229,acc,0,0,0,68881870,0
mgh078,2M4Y411134,20200201_20200229,eda,0,0,0,8552007,0
mgh078,2M4Y411134,20200201_20200229,temp,0,0,0,2138066,0
mgh079,2M4Y4111GM,20200201_20200229,acc,0,0,0,3238143,0
mgh079,2M4Y4111GM,20200201_20200229,eda,0,0,0,408147,0
mgh079,2M4Y4111GM,20200201_20200229,temp,0,0,0,102049,0
mgh081,2M4Y4111J3,20200201_20200229,acc,0,0,0,62952581,0
mgh081,2M4Y4111J3,20200201_20200229,eda,0,0,0,7850629,0
mgh081,2M4Y4111J3,20200201_20200229,temp,0,0,0,1962723,0
mgh082,2M4Y4111DQ,20200201_20200229,acc,0,0,0,7261320,0
mgh082,2M4Y4111DQ,20200201_20200229,eda,0,0,0,911300,0
mgh082,2M4Y4111DQ,20200201_20200229,temp,0,0,0,227830,0
mgh083,2M4Y4111G3,20200201_20200229,acc,0,0,0,16056850,0
mgh083,2M4Y4111G3,20200201_20200229,eda,0,0,0,2019641,0
mgh083,2M4Y4111G3,20200201_20200229,temp,0,0,0,504920,0
mgh085,2M4Y4111RV,20200201_20200229,acc,0,0,0,17670,0
mgh085,2M4Y4111RV,20200201_20200229,eda,0,0,0,2223,0
mgh085,2M4Y4111RV,20200201_20200229,temp,0,0,0,555,0
mgh087,2M4Y4111R8,20200201_20200229,acc,0,0,0,9293180,0
mgh087,2M4Y4111R8,20200201_20200229,eda,0,0,0,1150448,0
mgh087,2M4Y4111R8,20200201_20200229,temp,0,0,0,287615,0
mgh088,2M4Y41113F,20200201_20200229,acc,0,0,0,2949810,0
mgh088,2M4Y41113F,20200201_20200229,eda,0,0,0,370653,0
mgh088,2M4Y41113F,20200201_20200229,temp,0,0,0,92665,0
mgh090,2M4Y4111XF,20200201_20200229,acc,0,0,0,2277960,0
mgh090,2M4Y4111XF,20200201_20200229,eda,0,0,0,286988,0
mgh090,2M4Y4111XF,20200201_20200229,temp,0,0,0,71750,0
mgh091,2M4Y4111VW,20200201_20200229,acc,0,0,0,4708360,0
mgh091,2M4Y4111VW,20200201_20200229,eda,0,0,0,580424,0
mgh091,2M4Y4111VW,20200201_20200229,temp,0,0,0,145110,0
mgh092,2M4Y4111WM,20200201_20200229,acc,0,0,0,2740040,0
mgh092,2M4Y4111WM,20200201_20200229,eda,0,0,0,344435,0
mgh092,2M4Y4111WM,20200201_20200229,temp,0,0,0,86115,0
mgh093,2M4Y4111W7,20200201_20200229,acc,0,0,0,7273950,0
mgh093,2M4Y4111W7,20200201_20200229,eda,0,0,0,888342,0
mgh093,2M4Y4111W7,20200201_20200229,temp,0,0,0,222090,0
mgh094,2M4Y41113F,20200201_20200229,acc,0,0,0,1895560,0
mgh094,2M4Y41113F,20200201_20200229,eda,0,0,0,237926,0
mgh094,2M4Y41113F,20200201_20200229,temp,0,0,0,59485,0
mgh094,2M4Y4111WG,20200201_20200229,acc,0,0,0,15390,0
mgh094,2M4Y4111WG,20200201_20200229,eda,0,0,0,1937,0
mgh094,2M4Y4111WG,20200201_20200229,temp,0,0,0,485,0
mgh095,2M4Y4111WG,20200201_20200229,acc,0,0,0,1027180,0
mgh095,2M4Y4111WG,20200201_20200229,eda,0,0,0,128505,0
mgh095,2M4Y4111WG,20200201_20200229,temp,0,0,0,32130,0
fc015,2KPY311189,20200301_20200331,acc,0,0,0,45896871,0
fc015,2KPY311189,20200301_20200331,eda,0,0,0,5766061,0
fc015,2KPY311189,20200301_20200331,temp,0,0,0,1441554,0
fc019,2KPY31118N,20200301_20200331,acc,0,0,0,82536426,0
fc019,2KPY31118N,20200301_20200331,eda,0,0,0,10215475,0
fc019,2KPY31118N,20200301_20200331,temp,0,0,0,2553938,0
fc020,2KPY31117R,20200301_20200331,acc,0,0,0,43677920,0
fc020,2KPY31117R,20200301_20200331,eda,0,0,0,5459571,0
fc020,2KPY31117R,20200301_20200331,temp,0,0,0,1364940,0
fc022,2KPY311183,20200301_20200331,acc,0,0,0,14876190,0
fc022,2KPY311183,20200301_20200331,eda,0,0,0,1815697,0
fc022,2KPY311183,20200301_20200331,temp,0,0,0,453935,0
fc023,2KPY31111R,20200301_20200331,acc,0,0,0,2143670,0
fc023,2KPY31111R,20200301_20200331,eda,0,0,0,262717,0
fc023,2KPY31111R,20200301_20200331,temp,0,0,0,65680,0
fc026,2M4Y4111JP,20200301_20200331,acc,0,0,0,74753125,0
fc026,2M4Y4111JP,20200301_20200331,eda,0,0,0,9290818,0
fc026,2M4Y4111JP,20200301_20200331,temp,0,0,0,2322754,0
fc030,2M5Y41111N,20200301_20200331,acc,0,0,0,35613220,0
fc030,2M5Y41111N,20200301_20200331,eda,0,0,0,4357808,0
fc030,2M5Y41111N,20200301_20200331,temp,0,0,0,1089485,0
fc031,2M4Y4111J1,20200301_20200331,acc,0,0,0,327320,0
fc031,2M4Y4111J1,20200301_20200331,eda,0,0,0,41093,0
fc031,2M4Y4111J1,20200301_20200331,temp,0,0,0,10270,0
fc032,2M4Y4111DT,20200301_20200331,acc,0,0,0,26654880,0
fc032,2M4Y4111DT,20200301_20200331,eda,0,0,0,3319342,0
fc032,2M4Y4111DT,20200301_20200331,temp,0,0,0,829860,0
fc034,2M5Y411123,20200301_20200331,acc,0,0,0,65169488,0
fc034,2M5Y411123,20200301_20200331,eda,0,0,0,8085112,0
fc034,2M5Y411123,20200301_20200331,temp,0,0,0,2021340,0
fc037,2M4Y4111GH,20200301_20200331,acc,0,0,0,50573740,0
fc037,2M4Y4111GH,20200301_20200331,eda,0,0,0,6370182,0
fc037,2M4Y4111GH,20200301_20200331,temp,0,0,0,1592590,0
fc039,2M4Y4111HM,20200301_20200331,acc,0,0,0,25619221,0
fc039,2M4Y4111HM,20200301_20200331,eda,0,0,0,3213130,0
fc039,2M4Y4111HM,20200301_20200331,temp,0,0,0,803307,0
fc040,2M4Y4111J7,20200301_20200331,acc,0,0,0,84689986,0
fc040,2M4Y4111J7,20200301_20200331,eda,0,0,0,10413603,0
fc040,2M4Y4111J7,20200301_20200331,temp,0,0,0,2603482,0
fc041,2M4Y4111JM,20200301_20200331,acc,0,0,0,42945712,0
fc041,2M4Y4111JM,20200301_20200331,eda,0,0,0,5257189,0
fc041,2M4Y4111JM,20200301_20200331,temp,0,0,0,1314356,0
fc042,2M4Y4111HR,20200301_20200331,acc,0,0,0,33299362,0
fc042,2M4Y4111HR,20200301_20200331,eda,0,0,0,4083419,0
fc042,2M4Y4111HR,20200301_20200331,temp,0,0,0,1020879,0
fc043,2M4Y4111H3,20200301_20200331,acc,0,0,0,73412062,0
fc043,2M4Y4111H3,20200301_20200331,eda,0,0,0,9067692,0
fc043,2M4Y4111H3,20200301_20200331,temp,0,0,0,2266994,0
fc044,2M4Y4111GW,20200301_20200331,acc,0,0,0,11885260,0
fc044,2M4Y4111GW,20200301_20200331,eda,0,0,0,1461772,0
fc044,2M4Y4111GW,20200301_20200331,temp,0,0,0,365455,0
fc046,2M4Y4111HG,20200301_20200331,acc,0,0,0,32368591,0
fc046,2M4Y4111HG,20200301_20200331,eda,0,0,0,4044394,0
fc046,2M4Y4111HG,20200301_20200331,temp,0,0,0,1011125,0
fc048,2KPY31113Q,20200301_20200331,acc,0,0,0,26798013,0
fc048,2KPY31113Q,20200301_20200331,eda,0,0,0,3294803,0
fc048,2KPY31113Q,20200301_20200331,temp,0,0,0,823722,0
fc049,2M4Y4111JH,20200301_20200331,acc,0,0,16,80000698,16
fc049,2M4Y4111JH,20200301_20200331,eda,0,0,0,9858477,0
fc049,2M4Y4111JH,20200301_20200331,temp,0,0,0,2464682,0
fc050,2M4Y41123K,20200301_20200331,acc,0,0,0,52390014,0
fc050,2M4Y41123K,20200301_20200331,eda,0,0,0,6544465,0
fc050,2M4Y41123K,20200301_20200331,temp,0,0,0,1636180,0
fc051,2M4Y4111FD,20200301_20200331,acc,0,0,0,31758383,0
fc051,2M4Y4111FD,20200301_20200331,eda,0,0,0,3962986,0
fc051,2M4Y4111FD,20200301_20200331,temp,0,0,0,990780,0
fc053,2M4Y4111GN,20200301_20200331,acc,0,0,0,63314875,0
fc053,2M4Y4111GN,20200301_20200331,eda,0,0,0,7868583,0
fc053,2M4Y4111GN,20200301_20200331,temp,0,0,0,1967199,0
fc055,2M4Y4111QW,20200301_20200331,acc,0,0,0,55630405,0
fc055,2M4Y4111QW,20200301_20200331,eda,0,0,0,6914642,0
fc055,2M4Y4111QW,20200301_20200331,temp,0,0,0,1728710,0
fc056,2M4Y4111YJ,20200301_20200331,acc,0,0,0,58384792,0
fc056,2M4Y4111YJ,20200301_20200331,eda,0,0,0,7176241,0
fc056,2M4Y4111YJ,20200301_20200331,temp,0,0,0,1794110,0
fc057,2M4Y41114D,20200301_20200331,acc,0,0,0,34915758,0
fc057,2M4Y41114D,20200301_20200331,eda,0,0,0,4303866,0
fc057,2M4Y41114D,20200301_20200331,temp,0,0,0,1075985,0
fc058,2M4Y4111XM,20200301_20200331,acc,0,0,0,50651840,0
fc058,2M4Y4111XM,20200301_20200331,eda,0,0,0,6198660,0
fc058,2M4Y4111XM,20200301_20200331,temp,0,0,0,1549710,0
fc059,2M4Y4111RK,20200301_20200331,acc,0,0,0,39766056,0
fc059,2M4Y4111RK,20200301_20200331,eda,0,0,0,4971747,0
fc059,2M4Y4111RK,20200301_20200331,temp,0,0,0,1242970,0
fc060,2M4Y4111TC,20200301_20200331,acc,0,0,0,16567500,0
fc060,2M4Y4111TC,20200301_20200331,eda,0,0,0,2066064,0
fc060,2M4Y4111TC,20200301_20200331,temp,0,0,0,516535,0
fc061,2M4Y4111WN,20200301_20200331,acc,0,0,3654,43375279,3654
fc061,2M4Y4111WN,20200301_20200331,eda,0,0,16,5438176,16
fc061,2M4Y4111WN,20200301_20200331,temp,0,0,0,1357792,0
fc063,2M4Y4111VT,20200301_20200331,acc,0,0,0,26173291,0
fc063,2M4Y4111VT,20200301_20200331,eda,0,0,0,3258885,0
fc063,2M4Y4111VT,20200301_20200331,temp,0,0,0,814739,0
fc064,2M4Y4111G5,20200301_20200331,acc,0,0,0,14391797,0
fc064,2M4Y4111G5,20200301_20200331,eda,0,0,0,1805058,0
fc064,2M4Y4111G5,20200301_20200331,temp,0,0,0,451274,0
fc065,2KNY311221,20200301_20200331,acc,0,0,0,457170,0
fc065,2KNY311221,20200301_20200331,eda,0,0,0,56329,0
fc065,2KNY311221,20200301_20200331,temp,0,0,0,14085,0
fc067,2M4Y4111WJ,20200301_20200331,acc,0,0,0,19669840,0
fc067,2M4Y4111WJ,20200301_20200331,eda,0,0,0,2494202,0
fc067,2M4Y4111WJ,20200301_20200331,temp,0,0,0,623564,0
fc068,2M4Y4111VX,20200301_20200331,acc,0,0,0,29455653,0
fc068,2M4Y4111VX,20200301_20200331,eda,0,0,0,3676925,0
fc068,2M4Y4111VX,20200301_20200331,temp,0,0,0,919241,0
fc069,2KPY31118L,20200301_20200331,acc,0,0,0,1254780,0
fc069,2KPY31118L,20200301_20200331,eda,0,0,0,155740,0
fc069,2KPY31118L,20200301_20200331,temp,0,0,0,38935,0
fc070,2M4Y4111JV,20200301_20200331,acc,0,0,0,788780,0
fc070,2M4Y4111JV,20200301_20200331,eda,0,0,0,97266,0
fc070,2M4Y4111JV,20200301_20200331,temp,0,0,0,24320,0
mgh059,2KNY311211,20200301_20200331,acc,0,0,0,12607463,0
mgh059,2KNY311211,20200301_20200331,eda,0,0,0,1569019,0
mgh059,2KNY311211,20200301_20200331,temp,0,0,0,392266,0
mgh063,2KNY3111X2,20200301_20200331,acc,0,0,0,31669637,0
mgh063,2KNY3111X2,20200301_20200331,eda,0,0,0,3965787,0
mgh063,2KNY3111X2,20200301_20200331,temp,0,0,0,991468,0
mgh064,2KNY311216,20200301_20200331,acc,0,0,0,69524604,0
mgh064,2KNY311216,20200301_20200331,eda,0,0,0,8470367,0
mgh064,2KNY311216,20200301_20200331,temp,0,0,0,2117675,0
mgh067,2M4Y4111J5,20200301_20200331,acc,0,0,0,17825573,0
mgh067,2M4Y4111J5,20200301_20200331,eda,0,0,0,2232368,0
mgh067,2M4Y4111J5,20200301_20200331,temp,0,0,0,558115,0
mgh069,2KPY31117L,20200301_20200331,acc,0,0,0,4897720,0
mgh069,2KPY31117L,20200301_20200331,eda,0,0,0,604708,0
mgh069,2KPY31117L,20200301_20200331,temp,0,0,0,151180,0
mgh069,2KPY311186,20200301_20200331,acc,0,0,0,5210743,0
mgh069,2KPY311186,20200301_20200331,eda,0,0,0,635184,0
mgh069,2KPY311186,20200301_20200331,temp,0,0,0,158797,0
mgh071,2M4Y4111H9,20200301_20200331,acc,0,0,0,50468265,0
mgh071,2M4Y4111H9,20200301_20200331,eda,0,0,0,6266229,0
mgh071,2M4Y4111H9,20200301_20200331,temp,0,0,0,1566593,0
mgh075,2KNY311227,20200301_20200331,acc,0,0,0,41146197,0
mgh075,2KNY311227,20200301_20200331,eda,0,0,0,5143010,0
mgh075,2KNY311227,20200301_20200331,temp,0,0,0,1285789,0
mgh078,2M4Y411134,20200301_20200331,acc,0,0,0,16533891,0
mgh078,2M4Y411134,20200301_20200331,eda,0,0,0,2053217,0
mgh078,2M4Y411134,20200301_20200331,temp,0,0,0,513325,0
mgh079,2M4Y4111GM,20200301_20200331,acc,0,0,0,9552770,0
mgh079,2M4Y4111GM,20200301_20200331,eda,0,0,0,1199029,0
mgh079,2M4Y4111GM,20200301_20200331,temp,0,0,0,299760,0
mgh081,2M4Y4111J3,20200301_20200331,acc,0,0,0,35206426,0
mgh081,2M4Y4111J3,20200301_20200331,eda,0,0,0,4395144,0
mgh081,2M4Y4111J3,20200301_20200331,temp,0,0,0,1098814,0
mgh082,2M4Y4111DQ,20200301_20200331,acc,0,0,0,3290280,0
mgh082,2M4Y4111DQ,20200301_20200331,eda,0,0,0,411424,0
mgh082,2M4Y4111DQ,20200301_20200331,temp,0,0,0,102855,0
mgh087,2M4Y4111R8,20200301_20200331,acc,0,0,0,13111250,0
mgh087,2M4Y4111R8,20200301_20200331,eda,0,0,0,1623167,0
mgh087,2M4Y4111R8,20200301_20200331,temp,0,0,0,405770,0
mgh088,2M4Y41113F,20200301_20200331,acc,0,0,0,1644408,0
mgh088,2M4Y41113F,20200301_20200331,eda,0,0,0,206504,0
mgh088,2M4Y41113F,20200301_20200331,temp,0,0,0,51629,0
mgh090,2M4Y4111XF,20200301_20200331,acc,0,0,0,59479798,0
mgh090,2M4Y4111XF,20200301_20200331,eda,0,0,0,7433485,0
mgh090,2M4Y4111XF,20200301_20200331,temp,0,0,0,1858435,0
mgh091,2M4Y4111VW,20200301_20200331,acc,0,0,0,9915030,0
mgh091,2M4Y4111VW,20200301_20200331,eda,0,0,0,1221714,0
mgh091,2M4Y4111VW,20200301_20200331,temp,0,0,0,305445,0
mgh095,2M4Y41113G,20200301_20200331,acc,0,0,0,23407661,0
mgh095,2M4Y41113G,20200301_20200331,eda,0,0,0,2925472,0
mgh095,2M4Y41113G,20200301_20200331,temp,0,0,0,731392,0
mgh096,2M4Y411147,20200301_20200331,acc,0,0,0,42583650,0
mgh096,2M4Y411147,20200301_20200331,eda,0,0,0,5303038,0
mgh096,2M4Y411147,20200301_20200331,temp,0,0,0,1325780,0
mgh097,2M4Y411144,20200301_20200331,acc,0,0,0,5740190,0
mgh097,2M4Y411144,20200301_20200331,eda,0,0,0,715169,0
mgh097,2M4Y411144,20200301_20200331,temp,0,0,0,178795,0
mgh97T,2M4Y411148,20200301_20200331,acc,0,0,0,4674440,0
mgh97T,2M4Y411148,20200301_20200331,eda,0,0,0,585299,0
mgh97T,2M4Y411148,20200301_20200331,temp,0,0,0,146330,0
fc018,2KNY3111YR,20200401_20200430,acc,0,0,0,18412480,0
fc018,2KNY3111YR,20200401_20200430,eda,0,0,0,2316158,0
fc018,2KNY3111YR,20200401_20200430,temp,0,0,0,579050,0
fc019,2KPY31118N,20200401_20200430,acc,0,0,0,61482079,0
fc019,2KPY31118N,20200401_20200430,eda,0,0,0,7608876,0
fc019,2KPY31118N,20200401_20200430,temp,0,0,0,1902252,0
fc020,2KPY31117R,20200401_20200430,acc,0,0,0,29962810,0
fc020,2KPY31117R,20200401_20200430,eda,0,0,0,3748212,0
fc020,2KPY31117R,20200401_20200430,temp,0,0,0,937070,0
fc022,2KPY311183,20200401_20200430,acc,0,0,0,41737900,0
fc022,2KPY311183,20200401_20200430,eda,0,0,0,5096130,0
fc022,2KPY311183,20200401_20200430,temp,0,0,0,1274060,0
fc026,2M4Y4111JP,20200401_20200430,acc,0,0,0,62450996,0
fc026,2M4Y4111JP,20200401_20200430,eda,0,0,0,7755873,0
fc026,2M4Y4111JP,20200401_20200430,temp,0,0,0,1939022,0
fc034,2M5Y411123,20200401_20200430,acc,0,0,0,58845366,0
fc034,2M5Y411123,20200401_20200430,eda,0,0,0,7291609,0
fc034,2M5Y411123,20200401_20200430,temp,0,0,0,1822952,0
fc037,2M4Y4111GH,20200401_20200430,acc,0,0,16,37416366,16
fc037,2M4Y4111GH,20200401_20200430,eda,0,0,0,4694866,0
fc037,2M4Y4111GH,20200401_20200430,temp,0,0,0,1173769,0
fc039,2M4Y4111HM,20200401_20200430,acc,0,0,0,31972515,0
fc039,2M4Y4111HM,20200401_20200430,eda,0,0,0,4012577,0
fc039,2M4Y4111HM,20200401_20200430,temp,0,0,0,1003174,0
fc040,2M4Y4111J7,20200401_20200430,acc,0,0,0,79174975,0
fc040,2M4Y4111J7,20200401_20200430,eda,0,0,0,9736726,0
fc040,2M4Y4111J7,20200401_20200430,temp,0,0,0,2434242,0
fc041,2M4Y4111JM,20200401_20200430,acc,0,0,0,21905350,0
fc041,2M4Y4111JM,20200401_20200430,eda,0,0,0,2685956,0
fc041,2M4Y4111JM,20200401_20200430,temp,0,0,0,671515,0
fc042,2M4Y4111HR,20200401_20200430,acc,0,0,0,36917147,0
fc042,2M4Y4111HR,20200401_20200430,eda,0,0,0,4528297,0
fc042,2M4Y4111HR,20200401_20200430,temp,0,0,0,1132099,0
fc043,2M4Y4111H3,20200401_20200430,acc,0,0,0,53485146,0
fc043,2M4Y4111H3,20200401_20200430,eda,0,0,0,6609638,0
fc043,2M4Y4111H3,20200401_20200430,temp,0,0,0,1652455,0
fc045,2M4Y4111FK,20200401_20200430,acc,0,0,0,6241960,0
fc045,2M4Y4111FK,20200401_20200430,eda,0,0,0,783055,0
fc045,2M4Y4111FK,20200401_20200430,temp,0,0,0,195775,0
fc046,2M4Y4111HG,20200401_20200430,acc,0,0,0,33396536,0
fc046,2M4Y4111HG,20200401_20200430,eda,0,0,0,4168056,0
fc046,2M4Y4111HG,20200401_20200430,temp,0,0,0,1042058,0
fc048,2KPY31113Q,20200401_20200430,acc,0,0,0,7908595,0
fc048,2KPY31113Q,20200401_20200430,eda,0,0,0,974913,0
fc048,2KPY31113Q,20200401_20200430,temp,0,0,0,243732,0
fc049,2M4Y4111JH,20200401_20200430,acc,0,0,0,59813316,0
fc049,2M4Y4111JH,20200401_20200430,eda,0,0,0,7373136,0
fc049,2M4Y4111JH,20200401_20200430,temp,0,0,0,1843360,0
fc050,2M4Y41123K,20200401_20200430,acc,0,0,0,57148348,0
fc050,2M4Y41123K,20200401_20200430,eda,0,0,0,7140034,0
fc050,2M4Y41123K,20200401_20200430,temp,0,0,0,1785043,0
fc051,2M4Y4111FD,20200401_20200430,acc,0,0,0,45542725,0
fc051,2M4Y4111FD,20200401_20200430,eda,0,0,0,5690953,0
fc051,2M4Y4111FD,20200401_20200430,temp,0,0,0,1422774,0
fc055,2M4Y4111QW,20200401_20200430,acc,0,0,0,40262491,0
fc055,2M4Y4111QW,20200401_20200430,eda,0,0,0,5016018,0
fc055,2M4Y4111QW,20200401_20200430,temp,0,0,0,1254037,0
fc056,2M4Y4111YJ,20200401_20200430,acc,0,0,0,81308833,0
fc056,2M4Y4111YJ,20200401_20200430,eda,0,0,0,9993601,0
fc056,2M4Y4111YJ,20200401_20200430,temp,0,0,0,2498469,0
fc057,2M4Y41114D,20200401_20200430,acc,0,0,8,78195618,8
fc057,2M4Y41114D,20200401_20200430,eda,0,0,0,9643106,0
fc057,2M4Y41114D,20200401_20200430,temp,0,0,6,2410850,6
fc058,2M4Y4111XM,20200401_20200430,acc,0,0,0,25350680,0
fc058,2M4Y4111XM,20200401_20200430,eda,0,0,0,3104517,0
fc058,2M4Y4111XM,20200401_20200430,temp,0,0,0,776155,0
fc059,2M4Y4111RK,20200401_20200430,acc,0,0,0,66309705,0
fc059,2M4Y4111RK,20200401_20200430,eda,0,0,0,8284454,0
fc059,2M4Y4111RK,20200401_20200430,temp,0,0,0,2071173,0
fc061,2M4Y4111WN,20200401_20200430,acc,0,0,3693,64045722,3693
fc061,2M4Y4111WN,20200401_20200430,eda,0,0,80,8031965,80
fc061,2M4Y4111WN,20200401_20200430,temp,0,0,8,2008031,8
fc063,2M4Y4111VT,20200401_20200430,acc,0,0,8,32766787,8
fc063,2M4Y4111VT,20200401_20200430,eda,0,0,0,4081951,0
fc063,2M4Y4111VT,20200401_20200430,temp,0,0,0,1020525,0
fc064,2M4Y4111G5,20200401_20200430,acc,0,0,0,50200713,0
fc064,2M4Y4111G5,20200401_20200430,eda,0,0,0,6324541,0
fc064,2M4Y4111G5,20200401_20200430,temp,0,0,0,1581188,0
fc067,2M4Y4111WJ,20200401_20200430,acc,0,0,0,6162389,0
fc067,2M4Y4111WJ,20200401_20200430,eda,0,0,0,779519,0
fc067,2M4Y4111WJ,20200401_20200430,temp,0,0,0,194885,0
fc068,2M4Y4111VX,20200401_20200430,acc,0,0,20,76363822,20
fc068,2M4Y4111VX,20200401_20200430,eda,0,0,0,9535208,0
fc068,2M4Y4111VX,20200401_20200430,temp,0,0,0,2383857,0
fc069,2M4Y4111HT,20200401_20200430,acc,0,0,0,46316121,0
fc069,2M4Y4111HT,20200401_20200430,eda,0,0,0,5723190,0
fc069,2M4Y4111HT,20200401_20200430,temp,0,0,0,1430835,0
mgh064,2KNY311216,20200401_20200430,acc,0,0,0,15340429,0
mgh064,2KNY311216,20200401_20200430,eda,0,0,0,1868640,0
mgh064,2KNY311216,20200401_20200430,temp,0,0,0,467170,0
mgh069,2KPY311186,20200401_20200430,acc,0,0,0,48465385,0
mgh069,2KPY311186,20200401_20200430,eda,0,0,0,5906477,0
mgh069,2KPY311186,20200401_20200430,temp,0,0,0,1476662,0
mgh071,2M4Y4111H9,20200401_20200430,acc,0,0,0,29230527,0
mgh071,2M4Y4111H9,20200401_20200430,eda,0,0,0,3630362,0
mgh071,2M4Y4111H9,20200401_20200430,temp,0,0,0,907616,0
mgh075,2KNY311227,20200401_20200430,acc,0,0,0,44339868,0
mgh075,2KNY311227,20200401_20200430,eda,0,0,0,5544763,0
mgh075,2KNY311227,20200401_20200430,temp,0,0,0,1386235,0
mgh079,2M4Y4111GM,20200401_20200430,acc,0,0,0,766130,0
mgh079,2M4Y4111GM,20200401_20200430,eda,0,0,0,96447,0
mgh079,2M4Y4111GM,20200401_20200430,temp,0,0,0,24110,0
mgh081,2M4Y4111J3,20200401_20200430,acc,0,0,0,24127963,0
mgh081,2M4Y4111J3,20200401_20200430,eda,0,0,0,3003998,0
mgh081,2M4Y4111J3,20200401_20200430,temp,0,0,0,751021,0
mgh090,2M4Y4111XF,20200401_20200430,acc,0,0,0,71756180,0
mgh090,2M4Y4111XF,20200401_20200430,eda,0,0,0,8962847,0
mgh090,2M4Y4111XF,20200401_20200430,temp,0,0,0,2240769,0
mgh095,2M4Y41113G,20200401_20200430,acc,0,0,0,78285014,0
mgh095,2M4Y41113G,20200401_20200430,eda,0,0,0,9785543,0
mgh095,2M4Y41113G,20200401_20200430,temp,0,0,0,2446487,0
fc018,2KNY3111YR,20200501_20200531,acc,0,0,0,11135241,0
fc018,2KNY3111YR,20200501_20200531,eda,0,0,0,1399112,0
fc018,2KNY3111YR,20200501_20200531,temp,0,0,0,349788,0
fc026,2M4Y4111JP,20200501_20200531,acc,0,0,0,25969562,0
fc026,2M4Y4111JP,20200501_20200531,eda,0,0,0,3225230,0
fc026,2M4Y4111JP,20200501_20200531,temp,0,0,0,806325,0
fc034,2M5Y411123,20200501_20200531,acc,0,0,0,39779766,0
fc034,2M5Y411123,20200501_20200531,eda,0,0,0,4929819,0
fc034,2M5Y411123,20200501_20200531,temp,0,0,0,1232502,0
fc037,2M4Y4111GH,20200501_20200531,acc,0,0,0,59289733,0
fc037,2M4Y4111GH,20200501_20200531,eda,0,0,0,7443039,0
fc037,2M4Y4111GH,20200501_20200531,temp,0,0,0,1860807,0
fc039,2M4Y4111HM,20200501_20200531,acc,0,0,0,10093110,0
fc039,2M4Y4111HM,20200501_20200531,eda,0,0,0,1264341,0
fc039,2M4Y4111HM,20200501_20200531,temp,0,0,0,316090,0
fc040,2M4Y4111J7,20200501_20200531,acc,0,0,0,79653841,0
fc040,2M4Y4111J7,20200501_20200531,eda,0,0,0,9790330,0
fc040,2M4Y4111J7,20200501_20200531,temp,0,0,0,2447643,0
fc043,2M4Y4111H3,20200501_20200531,acc,0,0,0,46991015,0
fc043,2M4Y4111H3,20200501_20200531,eda,0,0,0,5801753,0
fc043,2M4Y4111H3,20200501_20200531,temp,0,0,0,1450492,0
fc046,2M4Y4111HG,20200501_20200531,acc,0,0,0,6591969,0
fc046,2M4Y4111HG,20200501_20200531,eda,0,0,0,823101,0
fc046,2M4Y4111HG,20200501_20200531,temp,0,0,0,205785,0
fc049,2M4Y4111JH,20200501_20200531,acc,0,0,8,61052672,8
fc049,2M4Y4111JH,20200501_20200531,eda,0,0,0,7523490,0
fc049,2M4Y4111JH,20200501_20200531,temp,0,0,0,1880915,0
fc050,2M4Y41123K,20200501_20200531,acc,0,0,0,27285324,0
fc050,2M4Y41123K,20200501_20200531,eda,0,0,0,3403798,0
fc050,2M4Y41123K,20200501_20200531,temp,0,0,0,850970,0
fc051,2M4Y4111FD,20200501_20200531,acc,0,0,0,60166340,0
fc051,2M4Y4111FD,20200501_20200531,eda,0,0,0,7512076,0
fc051,2M4Y4111FD,20200501_20200531,temp,0,0,0,1878055,0
fc053,2M4Y4111GN,20200501_20200531,acc,0,0,0,37636815,0
fc053,2M4Y4111GN,20200501_20200531,eda,0,0,0,4681953,0
fc053,2M4Y4111GN,20200501_20200531,temp,0,0,0,1170530,0
fc055,2M4Y4111QW,20200501_20200531,acc,0,0,0,37345844,0
fc055,2M4Y4111QW,20200501_20200531,eda,0,0,0,4644644,0
fc055,2M4Y4111QW,20200501_20200531,temp,0,0,0,1161198,0
fc056,2M4Y4111YJ,20200501_20200531,acc,0,0,0,78472528,0
fc056,2M4Y4111YJ,20200501_20200531,eda,0,0,0,9645007,0
fc056,2M4Y4111YJ,20200501_20200531,temp,0,0,0,2411326,0
fc057,2M4Y41114D,20200501_20200531,acc,0,0,0,12648600,0
fc057,2M4Y41114D,20200501_20200531,eda,0,0,0,1560083,0
fc057,2M4Y41114D,20200501_20200531,temp,0,0,0,390033,0
fc058,2M4Y4111XM,20200501_20200531,acc,0,0,0,28095970,0
fc058,2M4Y4111XM,20200501_20200531,eda,0,0,0,3435952,0
fc058,2M4Y4111XM,20200501_20200531,temp,0,0,0,859010,0
fc059,2M4Y4111RK,20200501_20200531,acc,0,0,0,58997183,0
fc059,2M4Y4111RK,20200501_20200531,eda,0,0,0,7383463,0
fc059,2M4Y4111RK,20200501_20200531,temp,0,0,0,1845922,0
fc061,2M4Y4111WN,20200501_20200531,acc,0,0,80205,78328485,80205
fc061,2M4Y4111WN,20200501_20200531,eda,0,0,1002,9820274,1002
fc061,2M4Y4111WN,20200501_20200531,temp,5,0,15,2455105,20
fc064,2M4Y4111G5,20200501_20200531,acc,0,0,0,53887948,0
fc064,2M4Y4111G5,20200501_20200531,eda,0,0,0,6767523,0
fc064,2M4Y4111G5,20200501_20200531,temp,0,0,0,1691924,0
fc068,2M4Y4111VX,20200501_20200531,acc,0,0,0,75942481,0
fc068,2M4Y4111VX,20200501_20200531,eda,0,0,0,9480516,0
fc068,2M4Y4111VX,20200501_20200531,temp,0,0,0,2370190,0
fc069,2M4Y4111HT,20200501_20200531,acc,0,0,0,34253027,0
fc069,2M4Y4111HT,20200501_20200531,eda,0,0,0,4222534,0
fc069,2M4Y4111HT,20200501_20200531,temp,0,0,0,1055669,0
mgh075,2KNY311227,20200501_20200531,acc,0,0,0,21226892,0
mgh075,2KNY311227,20200501_20200531,eda,0,0,0,2657850,0
mgh075,2KNY311227,20200501_20200531,temp,0,0,0,664474,0
mgh079,2M4Y4111GM,20200501_20200531,acc,0,0,0,6256710,0
mgh079,2M4Y4111GM,20200501_20200531,eda,0,0,0,782431,0
mgh079,2M4Y4111GM,20200501_20200531,temp,0,0,0,195610,0
mgh081,2M4Y4111J3,20200501_20200531,acc,0,0,0,29866515,0
mgh081,2M4Y4111J3,20200501_20200531,eda,0,0,0,3720625,0
mgh081,2M4Y4111J3,20200501_20200531,temp,0,0,0,930183,0
mgh090,2M4Y4111XF,20200501_20200531,acc,0,0,0,763707,0
mgh090,2M4Y4111XF,20200501_20200531,eda,0,0,0,95174,0
mgh090,2M4Y4111XF,20200501_20200531,temp,0,0,0,23794,0
mgh091,2M4Y4111VW,20200501_20200531,acc,0,0,0,29540882,0
mgh091,2M4Y4111VW,20200501_20200531,eda,0,0,0,3645210,0
mgh091,2M4Y4111VW,20200501_20200531,temp,0,0,0,911323,0
mgh095,2M4Y41113G,20200501_20200531,acc,0,0,0,81776324,0
mgh095,2M4Y41113G,20200501_20200531,eda,0,0,0,10224154,0
mgh095,2M4Y41113G,20200501_20200531,temp,4,0,2,2556092,6
mgh096,2M4Y411147,20200501_20200531,acc,0,0,0,231120,0
mgh096,2M4Y411147,20200501_20200531,eda,0,0,0,28691,0
mgh096,2M4Y411147,20200501_20200531,temp,0,0,0,7170,0
fc034,2M5Y411123,20200601_20200630,acc,0,0,0,7756505,0
fc034,2M5Y411123,20200601_20200630,eda,0,0,0,961327,0
fc034,2M5Y411123,20200601_20200630,temp,0,0,0,240341,0
fc037,2M4Y4111GH,20200601_20200630,acc,0,0,0,5000027,0
fc037,2M4Y4111GH,20200601_20200630,eda,0,0,0,627398,0
fc037,2M4Y4111GH,20200601_20200630,temp,0,0,0,156852,0
fc039,2M4Y4111HM,20200601_20200630,acc,0,0,0,74040,0
fc039,2M4Y4111HM,20200601_20200630,eda,0,0,0,9386,0
fc039,2M4Y4111HM,20200601_20200630,temp,0,0,0,2345,0
fc040,2M4Y4111J7,20200601_20200630,acc,0,0,0,40909097,0
fc040,2M4Y4111J7,20200601_20200630,eda,0,0,0,5024466,0
fc040,2M4Y4111J7,20200601_20200630,temp,0,0,0,1256151,0
fc042,2M4Y4111HR,20200601_20200630,acc,0,0,0,1913630,0
fc042,2M4Y4111HR,20200601_20200630,eda,0,0,0,237081,0
fc042,2M4Y4111HR,20200601_20200630,temp,0,0,0,59275,0
fc043,2M4Y4111H3,20200601_20200630,acc,0,0,0,67414814,0
fc043,2M4Y4111H3,20200601_20200630,eda,0,0,0,8312737,0
fc043,2M4Y4111H3,20200601_20200630,temp,0,0,0,2078248,0
fc049,2M4Y4111JH,20200601_20200630,acc,0,0,0,15803016,0
fc049,2M4Y4111JH,20200601_20200630,eda,0,0,0,1955885,0
fc049,2M4Y4111JH,20200601_20200630,temp,0,0,0,488984,0
fc053,2M4Y4111GN,20200601_20200630,acc,0,0,0,15345923,0
fc053,2M4Y4111GN,20200601_20200630,eda,0,0,0,1912631,0
fc053,2M4Y4111GN,20200601_20200630,temp,0,0,0,478174,0
fc055,2M4Y4111QW,20200601_20200630,acc,0,0,0,21707965,0
fc055,2M4Y4111QW,20200601_20200630,eda,0,0,0,2697453,0
fc055,2M4Y4111QW,20200601_20200630,temp,0,0,0,674376,0
fc056,2M4Y4111YJ,20200601_20200630,acc,0,0,0,49547730,0
fc056,2M4Y4111YJ,20200601_20200630,eda,0,0,0,6089959,0
fc056,2M4Y4111YJ,20200601_20200630,temp,0,0,0,1522527,0
fc057,2M4Y41114D,20200601_20200630,acc,0,0,0,16396495,0
fc057,2M4Y41114D,20200601_20200630,eda,0,0,0,2024463,0
fc057,2M4Y41114D,20200601_20200630,temp,0,0,0,506130,0
fc059,2M4Y4111RK,20200601_20200630,acc,0,0,0,14982614,0
fc059,2M4Y4111RK,20200601_20200630,eda,0,0,0,1876511,0
fc059,2M4Y4111RK,20200601_20200630,temp,0,0,0,469138,0
fc061,2M4Y4111WN,20200601_20200630,acc,0,0,1010,4681240,1010
fc061,2M4Y4111WN,20200601_20200630,eda,0,0,96,590174,96
fc061,2M4Y4111WN,20200601_20200630,temp,0,0,6,147550,6
fc064,2M4Y4111G5,20200601_20200630,acc,0,0,0,6782616,0
fc064,2M4Y4111G5,20200601_20200630,eda,0,0,0,851677,0
fc064,2M4Y4111G5,20200601_20200630,temp,0,0,0,212921,0
fc068,2M4Y4111VX,20200601_20200630,acc,0,0,0,62504700,0
fc068,2M4Y4111VX,20200601_20200630,eda,0,0,0,7805486,0
fc068,2M4Y4111VX,20200601_20200630,temp,0,0,0,1951430,0
fc069,2M4Y4111HT,20200601_20200630,acc,0,0,0,8452070,0
fc069,2M4Y4111HT,20200601_20200630,eda,0,0,0,1042431,0
fc069,2M4Y4111HT,20200601_20200630,temp,0,0,0,260615,0
fc070,2M4Y4111JV,20200601_20200630,acc,0,0,0,33874978,0
fc070,2M4Y4111JV,20200601_20200630,eda,0,0,0,4157223,0
fc070,2M4Y4111JV,20200601_20200630,temp,0,0,0,1039331,0
mgh090,2M4Y4111XF,20200601_20200630,acc,0,0,0,41664695,0
mgh090,2M4Y4111XF,20200601_20200630,eda,0,0,0,5196576,0
mgh090,2M4Y4111XF,20200601_20200630,temp,0,0,0,1299185,0
mgh091,2KPY31117N,20200601_20200630,acc,0,0,0,12263127,0
mgh091,2KPY31117N,20200601_20200630,eda,0,0,0,1511745,0
mgh091,2KPY31117N,20200601_20200630,temp,0,0,0,377948,0
mgh091,2M4Y4111VW,20200601_20200630,acc,0,0,0,16319816,0
mgh091,2M4Y4111VW,20200601_20200630,eda,0,0,0,2019445,0
mgh091,2M4Y4111VW,20200601_20200630,temp,0,0,0,504866,0
mgh095,2M4Y41113G,20200601_20200630,acc,0,0,0,79486573,0
mgh095,2M4Y41113G,20200601_20200630,eda,0,0,0,9933678,0
mgh095,2M4Y41113G,20200601_20200630,temp,0,0,0,2483479,0
fc043,2M4Y4111H3,20200701_20200731,acc,0,0,0,1822339,0
fc043,2M4Y4111H3,20200701_20200731,eda,0,0,0,225749,0
fc043,2M4Y4111H3,20200701_20200731,temp,0,0,0,56441,0
fc049,2M4Y4111JH,20200701_20200731,acc,0,0,0,28779640,0
fc049,2M4Y4111JH,20200701_20200731,eda,0,0,0,3544489,0
fc049,2M4Y4111JH,20200701_20200731,temp,0,0,0,886150,0
fc055,2M4Y4111QW,20200701_20200731,acc,0,0,0,11498090,0
fc055,2M4Y4111QW,20200701_20200731,eda,0,0,0,1430221,0
fc055,2M4Y4111QW,20200701_20200731,temp,0,0,0,357570,0
fc057,2M4Y41114D,20200701_20200731,acc,0,0,0,10459973,0
fc057,2M4Y41114D,20200701_20200731,eda,0,0,0,1289194,0
fc057,2M4Y41114D,20200701_20200731,temp,0,0,0,322299,0
fc059,2M4Y4111RK,20200701_20200731,acc,0,0,0,34519586,0
fc059,2M4Y4111RK,20200701_20200731,eda,0,0,0,4310674,0
fc059,2M4Y4111RK,20200701_20200731,temp,0,0,0,1077698,0
fc064,2M4Y4111G5,20200701_20200731,acc,0,0,0,7476080,0
fc064,2M4Y4111G5,20200701_20200731,eda,0,0,0,933023,0
fc064,2M4Y4111G5,20200701_20200731,temp,0,0,0,233265,0
fc068,2M4Y4111VX,20200701_20200731,acc,0,0,0,36125670,0
fc068,2M4Y4111VX,20200701_20200731,eda,0,0,0,4517890,0
fc068,2M4Y4111VX,20200701_20200731,temp,0,0,0,1129495,0
fc069,2M4Y4111HT,20200701_20200731,acc,0,0,0,12489630,0
fc069,2M4Y4111HT,20200701_20200731,eda,0,0,0,1542580,0
fc069,2M4Y4111HT,20200701_20200731,temp,0,0,0,385655,0
fc070,2M4Y4111JV,20200701_20200731,acc,0,0,0,59522059,0
fc070,2M4Y4111JV,20200701_20200731,eda,0,0,0,7288272,0
fc070,2M4Y4111JV,20200701_20200731,temp,0,0,0,1822117,0
fc071,2KNY3111M6,20200701_20200731,acc,0,0,0,10934430,0
fc071,2KNY3111M6,20200701_20200731,eda,0,0,0,1345032,0
fc071,2KNY3111M6,20200701_20200731,temp,0,0,0,336265,0
fc071,2M4Y4111W6,20200701_20200731,acc,0,0,0,1590,0
fc071,2M4Y4111W6,20200701_20200731,eda,0,0,0,195,0
fc071,2M4Y4111W6,20200701_20200731,temp,0,0,0,50,0
fc073,2M4Y4111RN,20200701_20200731,acc,0,0,0,10727630,0
fc073,2M4Y4111RN,20200701_20200731,eda,0,0,0,1335711,0
fc073,2M4Y4111RN,20200701_20200731,temp,0,0,0,333935,0
fc075,2M4Y4111W6,20200701_20200731,acc,0,0,0,16636660,0
fc075,2M4Y4111W6,20200701_20200731,eda,0,0,0,2078542,0
fc075,2M4Y4111W6,20200701_20200731,temp,0,0,0,519641,0
fc076,2KPY31118J,20200701_20200731,acc,0,0,0,33405512,0
fc076,2KPY31118J,20200701_20200731,eda,0,0,0,4177613,0
fc076,2KPY31118J,20200701_20200731,temp,0,0,0,1044432,0
fc077,2KNY3111Y8,20200701_20200731,acc,0,0,0,42176176,0
fc077,2KNY3111Y8,20200701_20200731,eda,0,0,0,5289319,0
fc077,2KNY3111Y8,20200701_20200731,temp,0,0,0,1322368,0
fc078,2M4Y4111J2,20200701_20200731,acc,0,0,0,1109530,0
fc078,2M4Y4111J2,20200701_20200731,eda,0,0,0,138554,0
fc078,2M4Y4111J2,20200701_20200731,temp,0,0,0,34635,0
mgh090,2M4Y4111XF,20200701_20200731,acc,0,0,0,60170908,0
mgh090,2M4Y4111XF,20200701_20200731,eda,0,0,0,7512825,0
mgh090,2M4Y4111XF,20200701_20200731,temp,0,0,0,1878259,0
mgh091,2KPY31117N,20200701_20200731,acc,0,0,0,60638031,0
mgh091,2KPY31117N,20200701_20200731,eda,0,0,0,7475632,0
mgh091,2KPY31117N,20200701_20200731,temp,0,0,0,1868951,0
mgh095,2M4Y41113G,20200701_20200731,acc,0,0,0,79105583,0
mgh095,2M4Y41113G,20200701_20200731,eda,0,0,0,9891211,0
mgh095,2M4Y41113G,20200701_20200731,temp,0,0,0,2472857,0
mgh098,2KPY31119K,20200701_20200731,acc,0,0,0,3184960,0
mgh098,2KPY31119K,20200701_20200731,eda,0,0,0,399360,0
mgh098,2KPY31119K,20200701_20200731,temp,0,0,0,99845,0
fc059,2M4Y4111RK,20200801_20200831,acc,0,0,0,10782620,0
fc059,2M4Y4111RK,20200801_20200831,eda,0,0,0,1349023,0
fc059,2M4Y4111RK,20200801_20200831,temp,0,0,0,337260,0
fc064,2M4Y4111G5,20200801_20200831,acc,0,0,0,8050370,0
fc064,2M4Y4111G5,20200801_20200831,eda,0,0,0,1003834,0
fc064,2M4Y4111G5,20200801_20200831,temp,0,0,0,250960,0
fc068,2M4Y4111VX,20200801_20200831,acc,0,0,0,17397810,0
fc068,2M4Y4111VX,20200801_20200831,eda,0,0,0,2181829,0
fc068,2M4Y4111VX,20200801_20200831,temp,0,0,0,545470,0
fc069,2M4Y4111HT,20200801_20200831,acc,0,0,0,1611120,0
fc069,2M4Y4111HT,20200801_20200831,eda,0,0,0,198627,0
fc069,2M4Y4111HT,20200801_20200831,temp,0,0,0,49660,0
fc070,2M4Y4111JV,20200801_20200831,acc,0,0,0,48571518,0
fc070,2M4Y4111JV,20200801_20200831,eda,0,0,0,5941979,0
fc070,2M4Y4111JV,20200801_20200831,temp,0,0,0,1485536,0
fc071,2KNY3111M6,20200801_20200831,acc,0,0,0,11872870,0
fc071,2KNY3111M6,20200801_20200831,eda,0,0,0,1466296,0
fc071,2KNY3111M6,20200801_20200831,temp,0,0,0,366580,0
fc074,2KPY31119G,20200801_20200831,acc,0,0,0,30472609,0
fc074,2KPY31119G,20200801_20200831,eda,0,0,0,3735862,0
fc074,2KPY31119G,20200801_20200831,temp,0,0,0,933991,0
fc075,2M4Y4111W6,20200801_20200831,acc,0,0,0,81984383,0
fc075,2M4Y4111W6,20200801_20200831,eda,0,0,0,10234355,0
fc075,2M4Y4111W6,20200801_20200831,temp,0,0,0,2558648,0
fc076,2KPY31118J,20200801_20200831,acc,0,0,0,7161776,0
fc076,2KPY31118J,20200801_20200831,eda,0,0,0,897206,0
fc076,2KPY31118J,20200801_20200831,temp,0,0,0,224317,0
fc077,2KNY3111Y8,20200801_20200831,acc,0,0,0,61173942,0
fc077,2KNY3111Y8,20200801_20200831,eda,0,0,0,7681024,0
fc077,2KNY3111Y8,20200801_20200831,temp,0,0,0,1920311,0
fc080,2KNY3111YJ,20200801_20200831,acc,0,0,0,74787552,0
fc080,2KNY3111YJ,20200801_20200831,eda,0,0,0,9299099,0
fc080,2KNY3111YJ,20200801_20200831,temp,0,0,0,2324833,0
fc081,2KPY31118Y,20200801_20200831,acc,0,0,0,2890194,0
fc081,2KPY31118Y,20200801_20200831,eda,0,0,0,352237,0
fc081,2KPY31118Y,20200801_20200831,temp,0,0,0,88063,0
fc083,2M4Y41112J,20200801_20200831,acc,0,0,0,20199200,0
fc083,2M4Y41112J,20200801_20200831,eda,0,0,0,2554084,0
fc083,2M4Y41112J,20200801_20200831,temp,0,0,0,638535,0
fc084,2M4Y4111X1,20200801_20200831,acc,0,0,0,14142280,0
fc084,2M4Y4111X1,20200801_20200831,eda,0,0,0,1730586,0
fc084,2M4Y4111X1,20200801_20200831,temp,0,0,0,432657,0
mgh090,2M4Y4111XF,20200801_20200831,acc,0,0,0,6465162,0
mgh090,2M4Y4111XF,20200801_20200831,eda,0,0,0,807133,0
mgh090,2M4Y4111XF,20200801_20200831,temp,0,0,0,201789,0
mgh091,2KPY31117N,20200801_20200831,acc,0,0,0,9965429,0
mgh091,2KPY31117N,20200801_20200831,eda,0,0,0,1228979,0
mgh091,2KPY31117N,20200801_20200831,temp,0,0,0,307251,0
mgh095,2M4Y41113G,20200801_20200831,acc,0,0,0,31348315,0
mgh095,2M4Y41113G,20200801_20200831,eda,0,0,0,3920153,0
mgh095,2M4Y41113G,20200801_20200831,temp,0,0,0,980073,0
mgh114,2KPY311193,20200801_20200831,acc,0,0,0,26242554,0
mgh114,2KPY311193,20200801_20200831,eda,0,0,0,3195542,0
mgh114,2KPY311193,20200801_20200831,temp,0,0,0,798912,0
fc070,2M4Y4111JV,20200901_20200930,acc,0,0,0,45848828,0
fc070,2M4Y4111JV,20200901_20200930,eda,0,0,0,5613739,0
fc070,2M4Y4111JV,20200901_20200930,temp,0,0,0,1403468,0
fc071,2KNY3111M6,20200901_20200930,acc,0,0,0,12064200,0
fc071,2KNY3111M6,20200901_20200930,eda,0,0,0,1486680,0
fc071,2KNY3111M6,20200901_20200930,temp,0,0,0,371685,0
fc074,2KPY31119G,20200901_20200930,acc,0,0,0,65251209,0
fc074,2KPY31119G,20200901_20200930,eda,0,0,0,8001464,0
fc074,2KPY31119G,20200901_20200930,temp,0,0,0,2000437,0
fc075,2M4Y4111W6,20200901_20200930,acc,0,0,0,48865992,0
fc075,2M4Y4111W6,20200901_20200930,eda,0,0,0,6102687,0
fc075,2M4Y4111W6,20200901_20200930,temp,0,0,0,1525709,0
fc077,2KNY3111Y8,20200901_20200930,acc,0,0,0,14644710,0
fc077,2KNY3111Y8,20200901_20200930,eda,0,0,0,1844258,0
fc077,2KNY3111Y8,20200901_20200930,temp,0,0,0,461075,0
fc080,2KNY3111YJ,20200901_20200930,acc,0,0,0,65080746,0
fc080,2KNY3111YJ,20200901_20200930,eda,0,0,0,8100305,0
fc080,2KNY3111YJ,20200901_20200930,temp,0,0,0,2025141,0
fc081,2KPY31118Y,20200901_20200930,acc,0,0,0,69106873,0
fc081,2KPY31118Y,20200901_20200930,eda,0,0,0,8426139,0
fc081,2KPY31118Y,20200901_20200930,temp,0,0,0,2106596,0
fc095,2KPY311192,20200901_20200930,acc,0,0,0,11570412,0
fc095,2KPY311192,20200901_20200930,eda,0,0,0,1452754,0
fc095,2KPY311192,20200901_20200930,temp,0,0,0,363194,0
mgh108,2KPY31118C,20200901_20200930,acc,0,0,0,16884110,0
mgh108,2KPY31118C,20200901_20200930,eda,0,0,0,2088093,0
mgh108,2KPY31118C,20200901_20200930,temp,0,0,0,522047,0
mgh113,2KNY3111QT,20200901_20200930,acc,0,0,0,23180397,0
mgh113,2KNY3111QT,20200901_20200930,eda,0,0,0,2892619,0
mgh113,2KNY3111QT,20200901_20200930,temp,0,0,0,723173,0
mgh114,2KPY311193,20200901_20200930,acc,0,0,0,23150414,0
mgh114,2KPY311193,20200901_20200930,eda,0,0,0,2824572,0
mgh114,2KPY311193,20200901_20200930,temp,0,0,0,706162,0
fc070,2M4Y4111JV,20201001_20201031,acc,0,0,0,20141100,0
fc070,2M4Y4111JV,20201001_20201031,eda,0,0,0,2465944,0
fc070,2M4Y4111JV,20201001_20201031,temp,0,0,0,616500,0
fc074,2KPY31119G,20201001_20201031,acc,0,0,0,50192147,0
fc074,2KPY31119G,20201001_20201031,eda,0,0,0,6165343,0
fc074,2KPY31119G,20201001_20201031,temp,0,0,0,1541370,0
fc087,2KNY3111L9,20201001_20201031,acc,0,0,0,25075300,0
fc074,2KPY31119G,20201101_20201130,eda,0,0,0,4800367,0
fc087,2KNY3111L9,20201001_20201031,eda,0,0,0,3126552,0
fc087,2KNY3111L9,20201001_20201031,temp,0,0,0,781665,0
fc095,2KPY311192,20201001_20201031,acc,0,0,0,7860287,0
fc095,2KPY311192,20201001_20201031,eda,0,0,0,987758,0
fc095,2KPY311192,20201001_20201031,temp,0,0,0,246949,0
fc096,2KNY311214,20201101_20201130,acc,0,0,0,62796942,0
fc096,2KNY311214,20201101_20201130,eda,0,0,0,7866064,0
fc096,2KNY311214,20201101_20201130,temp,5,0,1,1966566,6
fc101,2KPY31117K,20201101_20201130,acc,0,0,0,21430936,0
mgh113,2KNY3111QT,20201001_20201031,eda,0,0,0,5865969,0
mgh113,2KNY3111QT,20201001_20201031,temp,0,0,0,1466544,0
mgh114,2KPY311193,20201001_20201031,acc,0,0,0,13343338,0
mgh114,2KPY311193,20201001_20201031,eda,0,0,0,1633888,0
mgh114,2KPY311193,20201001_20201031,temp,0,0,0,408485,0
mgh113,2KNY3111QT,20201101_20201130,acc,0,0,0,69406328,0
mgh113,2KNY3111QT,20201101_20201130,eda,0,0,0,8658180,0
mgh113,2KNY3111QT,20201101_20201130,temp,0,0,0,2164600,0
mgh117,2KPY311174,20201101_20201130,acc,0,0,0,49740818,0
mgh117,2KPY311174,20201101_20201130,eda,0,0,0,6101716,0
mgh117,2KPY311174,20201101_20201130,temp,0,0,0,1525471,0
fc070,2M4Y4111JV,20201201_20201231,acc,0,0,0,15639180,0
fc070,2M4Y4111JV,20201201_20201231,eda,0,0,0,1916356,0
fc070,2M4Y4111JV,20201201_20201231,temp,0,0,0,479105,0
fc074,2KPY31119G,20201201_20201231,acc,0,0,0,16129590,0
fc074,2KPY31119G,20201201_20201231,eda,0,0,0,1982929,0
fc074,2KPY31119G,20201201_20201231,temp,4,0,2,495740,6
fc096,2KNY311214,20201201_20201231,acc,0,0,0,13657164,0
fc096,2KNY311214,20201201_20201231,eda,0,0,0,1713480,0
fc096,2KNY311214,20201201_20201231,temp,0,0,0,428363,0
fc101,2KPY31117K,20201201_20201231,acc,0,0,0,4096156,0
fc101,2KPY31117K,20201201_20201231,eda,0,0,0,503717,0
fc101,2KPY31117K,20201201_20201231,temp,0,0,0,125930,0
fc102,2KNY3111XH,20201201_20201231,acc,0,0,0,53172326,0
fc102,2KNY3111XH,20201201_20201231,eda,0,0,0,6645566,0
fc102,2KNY3111XH,20201201_20201231,temp,0,0,0,1661447,0
fc104,2KPY311188,20201201_20201231,acc,0,0,0,10654480,0
fc104,2KPY311188,20201201_20201231,eda,0,0,0,1321671,0
fc104,2KPY311188,20201201_20201231,temp,0,0,0,330430,0
fc109,2KPY31117C,20201201_20201231,acc,0,0,0,48090955,0
fc109,2KPY31117C,20201201_20201231,eda,0,0,0,5907938,0
fc109,2KPY31117C,20201201_20201231,temp,0,0,0,1477037,0
fc112,2KNY3111MM,20201201_20201231,acc,0,0,0,11899030,0
fc112,2KNY3111MM,20201201_20201231,eda,0,0,0,1480440,0
fc112,2KNY3111MM,20201201_20201231,temp,0,0,0,370125,0
fc113,2M4Y4111RV,20201201_20201231,acc,0,0,0,53230190,0
fc113,2M4Y4111RV,20201201_20201231,eda,0,0,0,6623917,0
fc113,2M4Y4111RV,20201201_20201231,temp,0,0,0,1656021,0
fc114,2M4Y4111FR,20201201_20201231,acc,0,0,0,62225192,0
fc114,2M4Y4111FR,20201201_20201231,eda,0,0,0,7727366,0
fc114,2M4Y4111FR,20201201_20201231,temp,0,0,0,1931895,0
fc115,2KPY31119Q,20201201_20201231,acc,0,0,0,8022670,0
fc115,2KPY31119Q,20201201_20201231,eda,0,0,0,1010763,0
fc115,2KPY31119Q,20201201_20201231,temp,0,0,0,252700,0
fc118,2M4Y4111H7,20201201_20201231,acc,0,0,0,18341380,0
fc118,2M4Y4111H7,20201201_20201231,eda,0,0,0,2267629,0
fc118,2M4Y4111H7,20201201_20201231,temp,0,0,0,566920,0
fc120,2M4Y4111RH,20201201_20201231,acc,0,0,0,39135870,0
fc120,2M4Y4111RH,20201201_20201231,eda,0,0,0,4812522,0
fc120,2M4Y4111RH,20201201_20201231,temp,0,0,0,1203160,0
fc122,2KPY31113T,20201201_20201231,acc,0,0,0,53033503,0
fc122,2KPY31113T,20201201_20201231,eda,0,0,0,6619779,0
fc122,2KPY31113T,20201201_20201231,temp,0,0,0,1654997,0
mgh113,2KNY3111QT,20201201_20201231,acc,0,0,0,21306289,0
mgh113,2KNY3111QT,20201201_20201231,eda,0,0,0,2668493,0
mgh113,2KNY3111QT,20201201_20201231,temp,0,0,0,667135,0
mgh117,2KPY311174,20201201_20201231,acc,0,0,0,48019609,0
mgh117,2KPY311174,20201201_20201231,eda,0,0,0,5890975,0
mgh117,2KPY311174,20201201_20201231,temp,0,0,0,1472778,0
mgh119,2M4Y4111RK,20201201_20201231,acc,0,0,0,6594700,0
mgh119,2M4Y4111RK,20201201_20201231,eda,0,0,0,827216,0
mgh119,2M4Y4111RK,20201201_20201231,temp,0,0,0,206815,0
mgh120,2M4Y4111DT,20201201_20201231,acc,0,0,0,35539320,0
mgh120,2M4Y4111DT,20201201_20201231,eda,0,0,0,4422380,0
mgh120,2M4Y4111DT,20201201_20201231,temp,0,0,0,1105614,0
mgh121,2M4Y4111VT,20201201_20201231,acc,0,0,0,58317580,0
mgh121,2M4Y4111VT,20201201_20201231,eda,0,0,0,7274800,0
mgh121,2M4Y4111VT,20201201_20201231,temp,0,0,0,1818740,0
fc074,2KPY31119G,20210101_20210131,acc,0,0,0,179690,0
fc074,2KPY31119G,20210101_20210131,eda,0,0,0,22243,0
fc074,2KPY31119G,20210101_20210131,temp,0,0,0,5560,0
fc102,2KNY3111XH,20210101_20210131,acc,0,0,0,78837381,0
fc102,2KNY3111XH,20210101_20210131,eda,0,0,0,9853568,0
fc102,2KNY3111XH,20210101_20210131,temp,0,0,0,2463454,0
fc107,2M4Y4111HX,20210101_20210131,acc,0,0,0,394170,0
fc107,2M4Y4111HX,20210101_20210131,eda,0,0,0,49985,0
fc107,2M4Y4111HX,20210101_20210131,temp,0,0,0,12490,0
fc109,2KPY31117C,20210101_20210131,acc,0,0,0,36265202,0
fc109,2KPY31117C,20210101_20210131,eda,0,0,0,4465798,0
fc109,2KPY31117C,20210101_20210131,temp,0,0,0,1116487,0
fc113,2M4Y4111RV,20210101_20210131,acc,0,0,0,47821688,0
fc113,2M4Y4111RV,20210101_20210131,eda,0,0,0,5950264,0
fc113,2M4Y4111RV,20210101_20210131,temp,0,0,0,1487578,0
fc114,2M4Y4111FR,20210101_20210131,acc,0,0,0,61526265,0
fc114,2M4Y4111FR,20210101_20210131,eda,0,0,0,7651175,0
fc114,2M4Y4111FR,20210101_20210131,temp,0,0,0,1912838,0
fc116,2M4Y4111JH,20210101_20210131,acc,0,0,0,10914410,0
fc116,2M4Y4111JH,20210101_20210131,eda,0,0,0,1349777,0
fc116,2M4Y4111JH,20210101_20210131,temp,0,0,0,337470,0
fc117,2KNY3111PT,20210101_20210131,acc,0,0,0,63779881,0
fc117,2KNY3111PT,20210101_20210131,eda,0,0,0,7966320,0
fc117,2KNY3111PT,20210101_20210131,temp,0,0,0,1991640,0
fc118,2M4Y4111H7,20210101_20210131,acc,0,0,0,40295457,0
fc118,2M4Y4111H7,20210101_20210131,eda,0,0,0,4976471,0
fc118,2M4Y4111H7,20210101_20210131,temp,0,0,0,1244101,0
fc119,2KPY311195,20210101_20210131,acc,0,0,0,21654591,0
fc119,2KPY311195,20210101_20210131,eda,0,0,0,2719503,0
fc119,2KPY311195,20210101_20210131,temp,0,0,0,679886,0
fc120,2M4Y4111RH,20210101_20210131,acc,0,0,0,14211990,0
fc120,2M4Y4111RH,20210101_20210131,eda,0,0,0,1755260,0
fc120,2M4Y4111RH,20210101_20210131,temp,0,0,0,438840,0
fc122,2KPY31113T,20210101_20210131,acc,0,0,0,65866925,0
fc122,2KPY31113T,20210101_20210131,eda,0,0,0,8227691,0
fc122,2KPY31113T,20210101_20210131,temp,0,0,0,2056980,0
fc125,2KNY3111NJ,20210101_20210131,acc,0,0,0,17466030,0
fc125,2KNY3111NJ,20210101_20210131,eda,0,0,0,2159469,0
fc125,2KNY3111NJ,20210101_20210131,temp,0,0,0,539873,0
fc126,2KNY3111NN,20210101_20210131,acc,0,0,0,3004820,0
fc126,2KNY3111NN,20210101_20210131,eda,0,0,0,375154,0
fc126,2KNY3111NN,20210101_20210131,temp,0,0,0,93790,0
fc127,2M4Y4111VX,20210101_20210131,acc,0,0,0,18721710,0
fc127,2M4Y4111VX,20210101_20210131,eda,0,0,0,2337309,0
fc127,2M4Y4111VX,20210101_20210131,temp,0,0,0,584340,0
fc129,2M4Y4111G3,20210101_20210131,acc,0,0,0,29324630,0
fc129,2M4Y4111G3,20210101_20210131,eda,0,0,0,3667833,0
fc129,2M4Y4111G3,20210101_20210131,temp,0,0,0,917027,0
mgh113,2KNY3111QT,20210101_20210131,acc,0,0,0,39584671,0
mgh113,2KNY3111QT,20210101_20210131,eda,0,0,0,4943440,0
mgh113,2KNY3111QT,20210101_20210131,temp,0,0,0,1235913,0
mgh117,2KPY311174,20210101_20210131,acc,0,0,0,11368670,0
mgh117,2KPY311174,20210101_20210131,eda,0,0,0,1401543,0
mgh117,2KPY311174,20210101_20210131,temp,0,0,0,350405,0
mgh120,2M4Y4111DT,20210101_20210131,acc,0,0,0,39144498,0
mgh120,2M4Y4111DT,20210101_20210131,eda,0,0,0,4872617,0
mgh120,2M4Y4111DT,20210101_20210131,temp,0,0,0,1218198,0
mgh121,2M4Y4111VT,20210101_20210131,acc,0,0,0,57269900,0
mgh121,2M4Y4111VT,20210101_20210131,eda,0,0,0,7163247,0
mgh121,2M4Y4111VT,20210101_20210131,temp,0,0,0,1790865,0
fc102,2KNY3111XH,20210201_20210228,acc,0,0,0,46291619,0
fc102,2KNY3111XH,20210201_20210228,eda,0,0,0,5793492,0
fc102,2KNY3111XH,20210201_20210228,temp,0,0,0,1448397,0
fc109,2KPY31117C,20210201_20210228,acc,0,0,0,43345009,0
fc109,2KPY31117C,20210201_20210228,eda,0,0,0,5321144,0
fc109,2KPY31117C,20210201_20210228,temp,0,0,0,1330316,0
fc110,2KNY311227,20210201_20210228,acc,0,0,0,627450,0
fc110,2KNY311227,20210201_20210228,eda,0,0,0,78234,0
fc110,2KNY311227,20210201_20210228,temp,0,0,0,19560,0
fc116,2M4Y4111JH,20210201_20210228,acc,0,0,0,5736222,0
fc116,2M4Y4111JH,20210201_20210228,eda,0,0,0,706318,0
fc116,2M4Y4111JH,20210201_20210228,temp,0,0,0,176583,0
fc117,2KNY3111PT,20210201_20210228,acc,0,0,0,44146057,0
fc117,2KNY3111PT,20210201_20210228,eda,0,0,0,5518225,0
fc117,2KNY3111PT,20210201_20210228,temp,0,0,0,1379584,0
fc118,2M4Y4111H7,20210201_20210228,acc,0,0,0,47481781,0
fc118,2M4Y4111H7,20210201_20210228,eda,0,0,0,5869724,0
fc118,2M4Y4111H7,20210201_20210228,temp,0,0,0,1467483,0
fc119,2KPY311195,20210201_20210228,acc,0,0,0,69162896,0
fc119,2KPY311195,20210201_20210228,eda,0,0,0,8682404,0
fc119,2KPY311195,20210201_20210228,temp,0,0,0,2170653,0
fc122,2KPY31113T,20210201_20210228,acc,0,0,0,24605258,0
fc122,2KPY31113T,20210201_20210228,eda,0,0,0,3069863,0
fc122,2KPY31113T,20210201_20210228,temp,0,0,0,767486,0
fc125,2KNY3111NJ,20210201_20210228,acc,0,0,0,63318090,0
fc125,2KNY3111NJ,20210201_20210228,eda,0,0,0,7826910,0
fc125,2KNY3111NJ,20210201_20210228,temp,0,0,0,1956750,0
fc126,2KNY3111NN,20210201_20210228,acc,0,0,0,7092970,0
fc126,2KNY3111NN,20210201_20210228,eda,0,0,0,893958,0
fc126,2KNY3111NN,20210201_20210228,temp,0,0,0,223490,0
fc127,2M4Y4111VX,20210201_20210228,acc,0,0,0,2443560,0
fc127,2M4Y4111VX,20210201_20210228,eda,0,0,0,304603,0
fc127,2M4Y4111VX,20210201_20210228,temp,0,0,0,76155,0
fc129,2M4Y4111G3,20210201_20210228,acc,0,0,0,67998826,0
fc129,2M4Y4111G3,20210201_20210228,eda,0,0,0,8521310,0
fc129,2M4Y4111G3,20210201_20210228,temp,0,0,0,2130399,0
fc131,2KPY31117X,20210201_20210228,acc,0,0,0,57176080,0
fc131,2KPY31117X,20210201_20210228,eda,0,0,0,7064395,0
fc131,2KPY31117X,20210201_20210228,temp,0,0,0,1766145,0
fc132,2M4Y4111GW,20210201_20210228,acc,0,0,0,56665151,0
fc132,2M4Y4111GW,20210201_20210228,eda,0,0,0,6975084,0
fc132,2M4Y4111GW,20210201_20210228,temp,0,0,0,1743809,0
fc133,2M4Y4111FM,20210201_20210228,acc,0,0,0,5904100,0
fc133,2M4Y4111FM,20210201_20210228,eda,0,0,0,733967,0
fc133,2M4Y4111FM,20210201_20210228,temp,0,0,0,183495,0
fc134,2M4Y4111QW,20210201_20210228,acc,0,0,0,2019660,0
fc134,2M4Y4111QW,20210201_20210228,eda,0,0,0,254163,0
fc134,2M4Y4111QW,20210201_20210228,temp,0,0,0,63540,0
fc135,2M4Y4111WJ,20210201_20210228,acc,0,0,0,30247871,0
fc135,2M4Y4111WJ,20210201_20210228,eda,0,0,0,3801247,0
fc135,2M4Y4111WJ,20210201_20210228,temp,0,0,0,950315,0
fc136,2M4Y4111FD,20210201_20210228,acc,0,0,0,29975335,0
fc136,2M4Y4111FD,20210201_20210228,eda,0,0,0,3737093,0
fc136,2M4Y4111FD,20210201_20210228,temp,0,0,0,934297,0
fc137,2M4Y4111J7,20210201_20210228,acc,0,0,0,16084040,0
fc137,2M4Y4111J7,20210201_20210228,eda,0,0,0,1989208,0
fc137,2M4Y4111J7,20210201_20210228,temp,0,0,0,497315,0
mgh113,2KNY3111QT,20210201_20210228,acc,0,0,0,30514938,0
mgh113,2KNY3111QT,20210201_20210228,eda,0,0,0,3809123,0
mgh113,2KNY3111QT,20210201_20210228,temp,0,0,0,952304,0
mgh119,2M4Y4111RK,20210201_20210228,acc,0,0,0,16292020,0
mgh119,2M4Y4111RK,20210201_20210228,eda,0,0,0,2057679,0
mgh119,2M4Y4111RK,20210201_20210228,temp,0,0,0,514440,0
mgh120,2M4Y4111DT,20210201_20210228,acc,0,0,0,27076679,0
mgh120,2M4Y4111DT,20210201_20210228,eda,0,0,0,3389141,0
mgh120,2M4Y4111DT,20210201_20210228,temp,0,0,0,847308,0
fc102,2KNY3111XH,20210301_20210331,acc,0,0,0,17193820,0
fc102,2KNY3111XH,20210301_20210331,eda,0,0,0,2151032,0
fc102,2KNY3111XH,20210301_20210331,temp,6,0,0,537745,6
fc109,2KPY31117C,20210301_20210331,acc,0,0,0,48011050,0
fc109,2KPY31117C,20210301_20210331,eda,0,0,0,5895904,0
fc109,2KPY31117C,20210301_20210331,temp,0,0,0,1474022,0
fc116,2M4Y4111JH,20210301_20210331,acc,0,0,0,46643545,0
fc116,2M4Y4111JH,20210301_20210331,eda,0,0,0,5765429,0
fc116,2M4Y4111JH,20210301_20210331,temp,0,0,0,1441401,0
fc117,2KNY3111PT,20210301_20210331,acc,0,0,0,25617860,0
fc117,2KNY3111PT,20210301_20210331,eda,0,0,0,3206021,0
fc117,2KNY3111PT,20210301_20210331,temp,0,0,0,801525,0
fc119,2KPY311195,20210301_20210331,acc,0,0,0,63201164,0
fc119,2KPY311195,20210301_20210331,eda,0,0,0,7940756,0
fc119,2KPY311195,20210301_20210331,temp,0,0,0,1985215,0
fc125,2KNY3111NJ,20210301_20210331,acc,0,0,0,75427750,0
fc125,2KNY3111NJ,20210301_20210331,eda,0,0,0,9328566,0
fc125,2KNY3111NJ,20210301_20210331,temp,0,0,0,2332185,0
fc127,2M4Y4111VX,20210301_20210331,acc,0,0,0,3532920,0
fc127,2M4Y4111VX,20210301_20210331,eda,0,0,0,442611,0
fc127,2M4Y4111VX,20210301_20210331,temp,0,0,0,110655,0
fc129,2M4Y4111G3,20210301_20210331,acc,0,0,0,43665621,0
fc129,2M4Y4111G3,20210301_20210331,eda,0,0,0,5486260,0
fc129,2M4Y4111G3,20210301_20210331,temp,0,0,0,1371592,0
fc131,2KPY31117X,20210301_20210331,acc,0,0,0,18162740,0
fc131,2KPY31117X,20210301_20210331,eda,0,0,0,2246465,0
fc131,2KPY31117X,20210301_20210331,temp,0,0,0,561630,0
fc132,2M4Y4111GW,20210301_20210331,acc,0,0,0,74440560,0
fc132,2M4Y4111GW,20210301_20210331,eda,0,0,14,9163862,14
fc132,2M4Y4111GW,20210301_20210331,temp,0,0,0,2291016,0
fc133,2M4Y4111FM,20210301_20210331,acc,0,0,0,9214280,0
fc133,2M4Y4111FM,20210301_20210331,eda,0,0,0,1147419,0
fc133,2M4Y4111FM,20210301_20210331,temp,0,0,0,286865,0
fc134,2M4Y4111QW,20210301_20210331,acc,0,0,0,5564750,0
fc134,2M4Y4111QW,20210301_20210331,eda,0,0,0,691002,0
fc134,2M4Y4111QW,20210301_20210331,temp,0,0,0,172755,0
fc135,2M4Y4111WJ,20210301_20210331,acc,0,0,0,40602872,0
fc135,2M4Y4111WJ,20210301_20210331,eda,0,0,0,5117704,0
fc135,2M4Y4111WJ,20210301_20210331,temp,0,0,0,1279457,0
fc136,2M4Y4111FD,20210301_20210331,acc,0,0,0,11979213,0
fc136,2M4Y4111FD,20210301_20210331,eda,0,0,0,1498640,0
fc136,2M4Y4111FD,20210301_20210331,temp,0,0,0,374667,0
fc137,2M4Y4111J7,20210301_20210331,acc,0,0,0,28763400,0
fc137,2M4Y4111J7,20210301_20210331,eda,0,0,0,3551327,0
fc137,2M4Y4111J7,20210301_20210331,temp,0,0,0,887850,0
fc138,2M4Y4111J5,20210301_20210331,acc,0,0,0,52165666,0
fc138,2M4Y4111J5,20210301_20210331,eda,0,0,0,6501096,0
fc138,2M4Y4111J5,20210301_20210331,temp,0,0,0,1625321,0
fc139,2M4Y4111QN,20210301_20210331,acc,0,0,0,13641000,0
fc139,2M4Y4111QN,20210301_20210331,eda,0,0,0,1690000,0
fc139,2M4Y4111QN,20210301_20210331,temp,0,0,0,422500,0
fc141,2M4Y4111HG,20210301_20210331,acc,0,0,0,39323330,0
fc141,2M4Y4111HG,20210301_20210331,eda,0,0,0,4905225,0
fc141,2M4Y4111HG,20210301_20210331,temp,0,0,0,1226330,0
mgh120,2M4Y4111DT,20210301_20210331,acc,0,0,0,37336901,0
mgh120,2M4Y4111DT,20210301_20210331,eda,0,0,0,4650666,0
mgh120,2M4Y4111DT,20210301_20210331,temp,0,0,0,1162699,0
fc102,2KNY3111XH,20210401_20210430,acc,0,0,0,931190,0
fc102,2KNY3111XH,20210401_20210430,eda,0,0,0,116727,0
fc102,2KNY3111XH,20210401_20210430,temp,0,0,0,29180,0
fc108,2M4Y4111H9,20210401_20210430,acc,0,0,0,906220,0
fc108,2M4Y4111H9,20210401_20210430,eda,0,0,0,113893,0
fc108,2M4Y4111H9,20210401_20210430,temp,0,0,0,28470,0
fc109,2KPY31117C,20210401_20210430,acc,0,0,0,2303696,0
fc109,2KPY31117C,20210401_20210430,eda,0,0,0,281912,0
fc109,2KPY31117C,20210401_20210430,temp,0,0,0,70480,0
fc116,2M4Y4111JH,20210401_20210430,acc,0,0,0,902090,0
fc116,2M4Y4111JH,20210401_20210430,eda,0,0,0,111293,0
fc116,2M4Y4111JH,20210401_20210430,temp,0,0,0,27830,0
fc117,2KNY3111PT,20210401_20210430,acc,0,0,0,3991820,0
fc117,2KNY3111PT,20210401_20210430,eda,0,0,0,498212,0
fc117,2KNY3111PT,20210401_20210430,temp,0,0,0,124540,0
fc119,2KPY311195,20210401_20210430,acc,0,0,26,31251853,26
fc119,2KPY311195,20210401_20210430,eda,0,0,0,3927884,0
fc119,2KPY311195,20210401_20210430,temp,0,0,0,981978,0
fc125,2KNY3111NJ,20210401_20210430,acc,0,0,0,64748161,0
fc125,2KNY3111NJ,20210401_20210430,eda,0,0,0,8005659,0
fc125,2KNY3111NJ,20210401_20210430,temp,0,0,0,2001457,0
fc127,2M4Y4111VX,20210401_20210430,acc,0,0,0,4120640,0
fc127,2M4Y4111VX,20210401_20210430,eda,0,0,0,515671,0
fc127,2M4Y4111VX,20210401_20210430,temp,0,0,0,128915,0
fc132,2M4Y4111GW,20210401_20210430,acc,0,0,0,57785813,0
fc132,2M4Y4111GW,20210401_20210430,eda,0,0,0,7127067,0
fc132,2M4Y4111GW,20210401_20210430,temp,0,0,0,1781811,0
fc135,2M4Y4111WJ,20210401_20210430,acc,0,0,0,36540230,0
fc135,2M4Y4111WJ,20210401_20210430,eda,0,0,0,4601160,0
fc135,2M4Y4111WJ,20210401_20210430,temp,0,0,0,1150324,0
fc136,2M4Y4111FD,20210401_20210430,acc,0,0,0,3639470,0
fc136,2M4Y4111FD,20210401_20210430,eda,0,0,0,454077,0
fc136,2M4Y4111FD,20210401_20210430,temp,0,0,0,113520,0
fc138,2M4Y4111J5,20210401_20210430,acc,0,0,0,56060542,0
fc138,2M4Y4111J5,20210401_20210430,eda,0,0,0,6993251,0
fc138,2M4Y4111J5,20210401_20210430,temp,0,0,0,1748363,0
fc139,2M4Y4111QN,20210401_20210430,acc,0,0,0,28233423,0
fc139,2M4Y4111QN,20210401_20210430,eda,0,0,0,3503337,0
fc139,2M4Y4111QN,20210401_20210430,temp,0,0,0,875850,0
fc141,2M4Y4111HG,20210401_20210430,acc,0,0,0,51619520,0
fc141,2M4Y4111HG,20210401_20210430,eda,0,0,0,6445491,0
fc141,2M4Y4111HG,20210401_20210430,temp,0,0,0,1611420,0
fc147,2M4Y4111GN,20210401_20210430,acc,0,0,0,5540240,0
fc147,2M4Y4111GN,20210401_20210430,eda,0,0,0,691431,0
fc147,2M4Y4111GN,20210401_20210430,temp,0,0,0,172860,0
fc149,2M4Y4111VW,20210401_20210430,acc,0,0,0,8319810,0
fc149,2M4Y4111VW,20210401_20210430,eda,0,0,0,1036243,0
fc149,2M4Y4111VW,20210401_20210430,temp,0,0,0,259065,0
fc150,2KPY311187,20210401_20210430,acc,0,0,0,9213600,0
fc150,2KPY311187,20210401_20210430,eda,0,0,0,1166087,0
fc150,2KPY311187,20210401_20210430,temp,0,0,0,291535,0
mgh120,2M4Y4111DT,20210401_20210430,acc,0,0,0,5966906,0
mgh120,2M4Y4111DT,20210401_20210430,eda,0,0,0,751430,0
mgh120,2M4Y4111DT,20210401_20210430,temp,0,0,0,187867,0
fc117,2KNY3111PT,20210501_20210531,acc,0,0,0,1008830,0
fc117,2KNY3111PT,20210501_20210531,eda,0,0,0,126386,0
fc117,2KNY3111PT,20210501_20210531,temp,0,0,0,31590,0
fc119,2M4Y411147,20210501_20210531,acc,0,0,0,5643610,0
fc119,2M4Y411147,20210501_20210531,eda,0,0,0,700167,0
fc119,2M4Y411147,20210501_20210531,temp,0,0,0,175050,0
fc125,2KNY3111NJ,20210501_20210531,acc,0,0,0,61468177,0
fc125,2KNY3111NJ,20210501_20210531,eda,0,0,0,7608742,0
fc125,2KNY3111NJ,20210501_20210531,temp,0,0,0,1902217,0
fc132,2M4Y4111GW,20210501_20210531,acc,0,0,0,26281090,0
fc132,2M4Y4111GW,20210501_20210531,eda,0,0,0,3246279,0
fc132,2M4Y4111GW,20210501_20210531,temp,0,0,0,811591,0
fc135,2M4Y4111WJ,20210501_20210531,acc,0,0,0,1733540,0
fc135,2M4Y4111WJ,20210501_20210531,eda,0,0,0,218075,0
fc135,2M4Y4111WJ,20210501_20210531,temp,0,0,0,54520,0
fc137,2M4Y4111J7,20210501_20210531,acc,0,0,0,506280,0
fc137,2M4Y4111J7,20210501_20210531,eda,0,0,0,62426,0
fc137,2M4Y4111J7,20210501_20210531,temp,0,0,0,15605,0
fc138,2M4Y4111J5,20210501_20210531,acc,0,0,0,36058952,0
fc138,2M4Y4111J5,20210501_20210531,eda,0,0,0,4504353,0
fc138,2M4Y4111J5,20210501_20210531,temp,0,0,0,1126132,0
fc139,2M4Y4111QN,20210501_20210531,acc,0,0,0,44220592,0
fc139,2M4Y4111QN,20210501_20210531,eda,0,0,0,5488629,0
fc139,2M4Y4111QN,20210501_20210531,temp,0,0,0,1372182,0
fc141,2M4Y4111HG,20210501_20210531,acc,0,0,0,54684130,0
fc141,2M4Y4111HG,20210501_20210531,eda,0,0,0,6830538,0
fc141,2M4Y4111HG,20210501_20210531,temp,0,0,0,1707685,0
fc148,2KPY311199,20210501_20210531,acc,0,0,0,1793100,0
fc148,2KPY311199,20210501_20210531,eda,0,0,0,227539,0
fc148,2KPY311199,20210501_20210531,temp,0,0,0,56885,0
fc149,2M4Y4111VW,20210501_20210531,acc,0,0,0,20394790,0
fc149,2M4Y4111VW,20210501_20210531,eda,0,0,0,2530008,0
fc149,2M4Y4111VW,20210501_20210531,temp,0,0,0,632545,0
fc153,2M4Y4111H3,20210501_20210531,acc,0,0,0,75159349,0
fc153,2M4Y4111H3,20210501_20210531,eda,0,0,0,9286610,0
fc153,2M4Y4111H3,20210501_20210531,temp,0,0,0,2321698,0
fc154,2KPY311186,20210501_20210531,acc,0,0,0,5707870,0
fc154,2KPY311186,20210501_20210531,eda,0,0,0,702000,0
fc154,2KPY311186,20210501_20210531,temp,0,0,0,175500,0
fc155,2M4Y4111JM,20210501_20210531,acc,0,0,0,74465662,0
fc155,2M4Y4111JM,20210501_20210531,eda,0,0,0,9104648,0
fc155,2M4Y4111JM,20210501_20210531,temp,0,0,0,2276223,0
fc156,2M4Y4111RN,20210501_20210531,acc,0,0,0,2040470,0
fc156,2M4Y4111RN,20210501_20210531,eda,0,0,0,256529,0
fc156,2M4Y4111RN,20210501_20210531,temp,0,0,0,64135,0
fc157,2M4Y4111FK,20210501_20210531,acc,0,0,0,34170252,0
fc157,2M4Y4111FK,20210501_20210531,eda,0,0,0,4283591,0
fc157,2M4Y4111FK,20210501_20210531,temp,0,0,0,1070926,0
fc158,2M5Y41111N,20210501_20210531,acc,0,0,0,47593847,0
fc158,2M5Y41111N,20210501_20210531,eda,0,0,0,5808368,0
fc158,2M5Y41111N,20210501_20210531,temp,0,0,0,1452128,0
fc165,2M4Y4111X7,20210501_20210531,acc,0,0,0,7352298,0
fc165,2M4Y4111X7,20210501_20210531,eda,0,0,0,921411,0
fc165,2M4Y4111X7,20210501_20210531,temp,0,0,0,230362,0
fc166,2M5Y411123,20210501_20210531,acc,0,0,0,4250,0
fc166,2M5Y411123,20210501_20210531,eda,0,0,0,520,0
fc166,2M5Y411123,20210501_20210531,temp,0,0,0,130,0
fc125,2KNY3111NJ,20210601_20210630,acc,0,0,0,3101590,0
fc125,2KNY3111NJ,20210601_20210630,eda,0,0,0,383708,0
fc125,2KNY3111NJ,20210601_20210630,temp,0,0,0,95925,0
fc132,2M4Y4111GW,20210601_20210630,acc,0,0,0,29525880,0
fc132,2M4Y4111GW,20210601_20210630,eda,0,0,0,3641963,0
fc132,2M4Y4111GW,20210601_20210630,temp,0,0,0,910510,0
fc138,2M4Y4111J5,20210601_20210630,acc,0,0,0,54821580,0
fc138,2M4Y4111J5,20210601_20210630,eda,0,0,0,6841539,0
fc138,2M4Y4111J5,20210601_20210630,temp,0,0,0,1710438,0
fc139,2M4Y4111QN,20210601_20210630,acc,0,0,0,25016150,0
fc139,2M4Y4111QN,20210601_20210630,eda,0,0,0,3100080,0
fc139,2M4Y4111QN,20210601_20210630,temp,0,0,0,775046,0
fc141,2M4Y4111HG,20210601_20210630,acc,0,0,0,59182220,0
fc141,2M4Y4111HG,20210601_20210630,eda,0,0,0,7377877,0
fc141,2M4Y4111HG,20210601_20210630,temp,0,0,0,1844525,0
fc148,2KPY311199,20210601_20210630,acc,0,0,0,14177090,0
fc148,2KPY311199,20210601_20210630,eda,0,0,0,1772563,0
fc148,2KPY311199,20210601_20210630,temp,0,0,0,443165,0
fc153,2M4Y4111H3,20210601_20210630,acc,0,0,0,71426047,0
fc153,2M4Y4111H3,20210601_20210630,eda,0,0,0,8811739,0
fc153,2M4Y4111H3,20210601_20210630,temp,5,0,1,2202971,6
fc155,2M4Y4111JM,20210601_20210630,acc,0,0,0,79108198,0
fc155,2M4Y4111JM,20210601_20210630,eda,0,0,0,9667369,0
fc155,2M4Y4111JM,20210601_20210630,temp,0,0,0,2416918,0
fc156,2M4Y4111RN,20210601_20210630,acc,0,0,0,3812600,0
fc156,2M4Y4111RN,20210601_20210630,eda,0,0,0,477698,0
fc156,2M4Y4111RN,20210601_20210630,temp,0,0,0,119430,0
fc157,2M4Y4111FK,20210601_20210630,acc,0,0,0,72247716,0
fc157,2M4Y4111FK,20210601_20210630,eda,0,0,0,9040287,0
fc157,2M4Y4111FK,20210601_20210630,temp,0,0,0,2260138,0
fc158,2M5Y41111N,20210601_20210630,acc,0,0,42,56985765,42
fc158,2M5Y41111N,20210601_20210630,eda,0,0,0,6958734,0
fc158,2M5Y41111N,20210601_20210630,temp,0,15,0,1739756,0
fc163,2KPY31116L,20210601_20210630,acc,0,0,0,17616760,0
fc163,2KPY31116L,20210601_20210630,eda,0,0,0,2153021,0
fc163,2KPY31116L,20210601_20210630,temp,0,0,0,538300,0
fc165,2M4Y4111X7,20210601_20210630,acc,0,0,0,67476301,0
fc165,2M4Y4111X7,20210601_20210630,eda,0,0,0,8399780,0
fc165,2M4Y4111X7,20210601_20210630,temp,0,0,0,2100017,0
fc167,2M4Y4111H7,20210601_20210630,acc,0,0,0,3814540,0
fc167,2M4Y4111H7,20210601_20210630,eda,0,0,0,468442,0
fc167,2M4Y4111H7,20210601_20210630,temp,0,0,0,117105,0
fc168,2KNY3111X2,20210601_20210630,acc,0,0,0,1991970,0
fc168,2KNY3111X2,20210601_20210630,eda,0,0,0,252460,0
fc168,2KNY3111X2,20210601_20210630,temp,0,0,0,63115,0
fc169,2M4Y41122K,20210601_20210630,acc,0,0,0,48663284,0
fc169,2M4Y41122K,20210601_20210630,eda,0,0,0,5998190,0
fc169,2M4Y41122K,20210601_20210630,temp,0,0,0,1499572,0
fc170,2M4Y4111F3,20210601_20210630,acc,0,0,0,13434249,0
fc170,2M4Y4111F3,20210601_20210630,eda,0,0,0,1681433,0
fc170,2M4Y4111F3,20210601_20210630,temp,0,0,0,420366,0
fc171,2KPY31117K,20210601_20210630,acc,0,0,0,1642648,0
fc171,2KPY31117K,20210601_20210630,eda,0,0,0,202027,0
fc171,2KPY31117K,20210601_20210630,temp,0,0,0,50510,0
fc176,2M4Y41113M,20210601_20210630,acc,0,0,0,975788,0
fc176,2M4Y41113M,20210601_20210630,eda,0,0,0,122244,0
fc176,2M4Y41113M,20210601_20210630,temp,0,0,0,30562,0
fc177,2M4Y4111TC,20210601_20210630,acc,0,0,0,920579,0
fc177,2M4Y4111TC,20210601_20210630,eda,0,0,0,115345,0
fc177,2M4Y4111TC,20210601_20210630,temp,0,0,0,28837,0
fc178,2KNY3111PT,20210601_20210630,acc,0,0,0,20030,0
fc178,2KNY3111PT,20210601_20210630,eda,0,0,0,2509,0
fc178,2KNY3111PT,20210601_20210630,temp,0,0,0,625,0
fc179,2KPY31117Y,20210601_20210630,acc,0,0,0,0,0
fc179,2KPY31117Y,20210601_20210630,eda,0,0,0,0,0
fc179,2KPY31117Y,20210601_20210630,temp,0,0,0,0,0
fc132,2M4Y4111GW,20210701_20210731,acc,0,0,0,8272510,0
fc132,2M4Y4111GW,20210701_20210731,eda,0,0,0,1017016,0
fc132,2M4Y4111GW,20210701_20210731,temp,0,0,0,254260,0
fc138,2M4Y4111J5,20210701_20210731,acc,0,0,0,39537840,0
fc138,2M4Y4111J5,20210701_20210731,eda,0,0,0,4933508,0
fc138,2M4Y4111J5,20210701_20210731,temp,0,0,0,1233405,0
fc139,2M4Y4111QN,20210701_20210731,acc,0,0,0,32340343,0
fc139,2M4Y4111QN,20210701_20210731,eda,0,0,0,4014861,0
fc139,2M4Y4111QN,20210701_20210731,temp,0,0,0,1003756,0
fc141,2M4Y4111HG,20210701_20210731,acc,0,0,0,47934930,0
fc141,2M4Y4111HG,20210701_20210731,eda,0,0,0,5984238,0
fc141,2M4Y4111HG,20210701_20210731,temp,0,0,0,1496110,0
fc149,2M4Y4111VW,20210701_20210731,acc,0,0,0,5724590,0
fc149,2M4Y4111VW,20210701_20210731,eda,0,0,0,709735,0
fc149,2M4Y4111VW,20210701_20210731,temp,0,0,0,177440,0
fc153,2M4Y4111H3,20210701_20210731,acc,0,0,0,81355234,0
fc153,2M4Y4111H3,20210701_20210731,eda,0,0,14,10043257,14
fc153,2M4Y4111H3,20210701_20210731,temp,0,0,0,2510892,0
fc155,2M4Y4111JM,20210701_20210731,acc,0,0,0,63462679,0
fc155,2M4Y4111JM,20210701_20210731,eda,0,0,0,7762107,0
fc155,2M4Y4111JM,20210701_20210731,temp,0,0,0,1940589,0
fc157,2M4Y4111FK,20210701_20210731,acc,0,0,0,71206310,0
fc157,2M4Y4111FK,20210701_20210731,eda,0,0,0,8917837,0
fc157,2M4Y4111FK,20210701_20210731,temp,0,0,0,2229524,0
fc158,2M5Y41111N,20210701_20210731,acc,0,0,0,37101683,0
fc158,2M5Y41111N,20210701_20210731,eda,0,0,0,4540999,0
fc158,2M5Y41111N,20210701_20210731,temp,0,0,0,1135284,0
fc163,2KPY31116L,20210701_20210731,acc,0,0,0,32943940,0
fc163,2KPY31116L,20210701_20210731,eda,0,0,0,4051203,0
fc163,2KPY31116L,20210701_20210731,temp,0,0,0,1012845,0
fc165,2M4Y4111X7,20210701_20210731,acc,0,0,0,60033450,0
fc165,2M4Y4111X7,20210701_20210731,eda,0,0,0,7487155,0
fc165,2M4Y4111X7,20210701_20210731,temp,0,0,0,1871840,0
fc167,2M4Y4111H7,20210701_20210731,acc,0,0,0,3350,0
fc167,2M4Y4111H7,20210701_20210731,eda,0,0,0,403,0
fc167,2M4Y4111H7,20210701_20210731,temp,0,0,0,100,0
fc169,2M4Y41122K,20210701_20210731,acc,0,0,38,79370725,38
fc169,2M4Y41122K,20210701_20210731,eda,0,0,2,9793805,2
fc169,2M4Y41122K,20210701_20210731,temp,5,0,1,2448520,6
fc170,2M4Y4111F3,20210701_20210731,acc,0,0,0,7183249,0
fc170,2M4Y4111F3,20210701_20210731,eda,0,0,0,903691,0
fc170,2M4Y4111F3,20210701_20210731,temp,0,0,0,225928,0
fc171,2KPY31117K,20210701_20210731,acc,0,0,0,23847329,0
fc171,2KPY31117K,20210701_20210731,eda,0,0,0,2941668,0
fc171,2KPY31117K,20210701_20210731,temp,0,0,0,735444,0
fc173,2M4Y4111Y9,20210701_20210731,acc,0,0,0,30247568,0
fc173,2M4Y4111Y9,20210701_20210731,eda,0,0,0,3775036,0
fc173,2M4Y4111Y9,20210701_20210731,temp,0,0,0,943785,0
fc174,2M4Y4111JV,20210701_20210731,acc,0,0,0,7512230,0
fc174,2M4Y4111JV,20210701_20210731,eda,0,0,0,923234,0
fc174,2M4Y4111JV,20210701_20210731,temp,0,0,0,230810,0
fc175,2M4Y4111QW,20210701_20210731,acc,0,0,0,7837639,0
fc175,2M4Y4111QW,20210701_20210731,eda,0,0,0,971715,0
fc175,2M4Y4111QW,20210701_20210731,temp,0,0,0,242933,0
fc176,2M4Y41113M,20210701_20210731,acc,0,0,0,1665360,0
fc176,2M4Y41113M,20210701_20210731,eda,0,0,0,208641,0
fc176,2M4Y41113M,20210701_20210731,temp,0,0,0,52157,0
fc177,2M4Y4111TC,20210701_20210731,acc,0,0,0,1539757,0
fc177,2M4Y4111TC,20210701_20210731,eda,0,0,0,193050,0
fc177,2M4Y4111TC,20210701_20210731,temp,0,0,0,48262,0
fc179,2KPY31117Y,20210701_20210731,acc,0,0,0,3090920,0
fc179,2KPY31117Y,20210701_20210731,eda,0,0,0,389142,0
fc179,2KPY31117Y,20210701_20210731,temp,0,0,0,97290,0
fc182,2M4Y4111J3,20210701_20210731,acc,0,0,0,1558,0
fc182,2M4Y4111J3,20210701_20210731,eda,0,0,0,195,0
fc182,2M4Y4111J3,20210701_20210731,temp,0,0,0,46,0
mgh130,2KPY31118N,20210701_20210731,acc,0,0,0,25658907,0
mgh130,2KPY31118N,20210701_20210731,eda,0,0,0,3175248,0
mgh130,2KPY31118N,20210701_20210731,temp,0,0,0,793829,0
fc138,2M4Y4111J5,20210801_20210831,acc,0,0,0,2321502,0
fc138,2M4Y4111J5,20210801_20210831,eda,0,0,0,290258,0
fc138,2M4Y4111J5,20210801_20210831,temp,0,0,0,72547,0
fc139,2M4Y4111QN,20210801_20210831,acc,0,0,0,12381024,0
fc139,2M4Y4111QN,20210801_20210831,eda,0,0,0,1535788,0
fc139,2M4Y4111QN,20210801_20210831,temp,0,0,0,383957,0
fc141,2M4Y4111HG,20210801_20210831,acc,0,0,0,35839770,0
fc141,2M4Y4111HG,20210801_20210831,eda,0,0,0,4474756,0
fc141,2M4Y4111HG,20210801_20210831,temp,0,0,0,1118730,0
fc153,2M4Y4111H3,20210801_20210831,acc,0,0,0,66867852,0
fc153,2M4Y4111H3,20210801_20210831,eda,0,0,0,8263612,0
fc153,2M4Y4111H3,20210801_20210831,temp,0,0,0,2065901,0
fc154,2KPY311186,20210801_20210831,acc,0,0,0,10710,0
fc154,2KPY311186,20210801_20210831,eda,0,0,0,1313,0
fc154,2KPY311186,20210801_20210831,temp,0,0,0,325,0
fc155,2M4Y4111JM,20210801_20210831,acc,0,0,0,70119522,0
fc155,2M4Y4111JM,20210801_20210831,eda,0,0,0,8576316,0
fc155,2M4Y4111JM,20210801_20210831,temp,0,0,0,2144132,0
fc157,2M4Y4111FK,20210801_20210831,acc,0,0,0,80638280,0
fc157,2M4Y4111FK,20210801_20210831,eda,0,0,0,10094667,0
fc157,2M4Y4111FK,20210801_20210831,temp,0,0,0,2523744,0
fc158,2M5Y41111N,20210801_20210831,acc,0,0,0,14326840,0
fc158,2M5Y41111N,20210801_20210831,eda,0,0,0,1748877,0
fc158,2M5Y41111N,20210801_20210831,temp,0,0,0,437220,0
fc163,2KPY31116L,20210801_20210831,acc,0,0,0,13342280,0
fc163,2KPY31116L,20210801_20210831,eda,0,0,0,1632189,0
fc163,2KPY31116L,20210801_20210831,temp,0,0,0,408055,0
fc165,2M4Y4111X7,20210801_20210831,acc,0,0,0,68321400,0
fc165,2M4Y4111X7,20210801_20210831,eda,0,0,0,8510151,0
fc165,2M4Y4111X7,20210801_20210831,temp,0,0,0,2127610,0
fc169,2M4Y41122K,20210801_20210831,acc,0,0,0,17066257,0
fc169,2M4Y41122K,20210801_20210831,eda,0,0,0,2107255,0
fc169,2M4Y41122K,20210801_20210831,temp,0,0,0,526821,0
fc173,2M4Y4111Y9,20210801_20210831,acc,0,0,0,2939060,0
fc173,2M4Y4111Y9,20210801_20210831,eda,0,0,0,366071,0
fc173,2M4Y4111Y9,20210801_20210831,temp,0,0,0,91519,0
fc175,2M4Y4111QW,20210801_20210831,acc,0,0,0,943569,0
fc175,2M4Y4111QW,20210801_20210831,eda,0,0,0,116862,0
fc175,2M4Y4111QW,20210801_20210831,temp,0,0,0,29216,0
fc176,2M4Y41113M,20210801_20210831,acc,0,0,0,41014410,0
fc176,2M4Y41113M,20210801_20210831,eda,0,0,0,5108129,0
fc176,2M4Y41113M,20210801_20210831,temp,0,0,0,1277055,0
fc177,2M4Y4111TC,20210801_20210831,acc,0,0,0,47755560,0
fc177,2M4Y4111TC,20210801_20210831,eda,0,0,0,5977422,0
fc177,2M4Y4111TC,20210801_20210831,temp,0,0,0,1494409,0
fc179,2KPY31117Y,20210801_20210831,acc,0,0,0,10313630,0
fc179,2KPY31117Y,20210801_20210831,eda,0,0,0,1287806,0
fc179,2KPY31117Y,20210801_20210831,temp,0,0,0,321955,0
fc182,2KNY3111N4,20210801_20210831,acc,0,0,0,75447,0
fc182,2KNY3111N4,20210801_20210831,eda,0,0,0,9508,0
fc182,2KNY3111N4,20210801_20210831,temp,0,0,0,2377,0
fc183,2KPY31117M,20210801_20210831,acc,0,0,0,814252,0
fc183,2KPY31117M,20210801_20210831,eda,0,0,0,101715,0
fc183,2KPY31117M,20210801_20210831,temp,0,0,0,25426,0
fc184,2M4Y4111FM,20210801_20210831,acc,0,0,0,42997832,0
fc184,2M4Y4111FM,20210801_20210831,eda,0,0,0,5290065,0
fc184,2M4Y4111FM,20210801_20210831,temp,0,0,0,1322546,0
fc185,2KPY31119V,20210801_20210831,acc,0,0,0,2026,0
fc185,2KPY31119V,20210801_20210831,eda,0,0,0,251,0
fc185,2KPY31119V,20210801_20210831,temp,0,0,0,64,0
fc185,2M4Y4111JH,20210801_20210831,acc,0,0,0,16906510,0
fc185,2M4Y4111JH,20210801_20210831,eda,0,0,0,1210261,0
fc185,2M4Y4111JH,20210801_20210831,temp,0,0,0,522015,0
fc186,2KPY31118W,20210801_20210831,acc,0,0,0,569090,0
fc186,2KPY31118W,20210801_20210831,eda,0,0,0,70057,0
fc186,2KPY31118W,20210801_20210831,temp,0,0,0,17515,0
fc188,2KNY3111QT,20210801_20210831,acc,0,0,0,28780902,0
fc188,2KNY3111QT,20210801_20210831,eda,0,0,0,3602869,0
fc188,2KNY3111QT,20210801_20210831,temp,0,0,0,900746,0
fc191,2M4Y4111HT,20210801_20210831,acc,0,0,0,167310,0
fc191,2M4Y4111HT,20210801_20210831,eda,0,0,0,20839,0
fc191,2M4Y4111HT,20210801_20210831,temp,0,0,0,5210,0
fc192,2KNY3111X2,20210801_20210831,acc,0,0,0,7101511,0
fc192,2KNY3111X2,20210801_20210831,eda,0,0,0,888794,0
fc192,2KNY3111X2,20210801_20210831,temp,0,0,0,222208,0
fc193,2M4Y4111VX,20210801_20210831,acc,0,0,0,50537,0
fc193,2M4Y4111VX,20210801_20210831,eda,0,0,0,6372,0
fc193,2M4Y4111VX,20210801_20210831,temp,0,0,0,1593,0
fc195,2M4Y4111J7,20210801_20210831,acc,0,0,0,2899,0
fc195,2M4Y4111J7,20210801_20210831,eda,0,0,0,357,0
fc195,2M4Y4111J7,20210801_20210831,temp,0,0,0,90,0
fc196,2M4Y4111QN,20210801_20210831,acc,0,0,0,2032,0
fc196,2M4Y4111QN,20210801_20210831,eda,0,0,0,253,0
fc196,2M4Y4111QN,20210801_20210831,temp,0,0,0,63,0
mgh130,2KPY31118N,20210801_20210831,acc,0,0,0,46753060,0
mgh130,2KPY31118N,20210801_20210831,eda,0,0,0,5780032,0
mgh130,2KPY31118N,20210801_20210831,temp,0,0,0,1445030,0
mgh132,2KNY311211,20210801_20210831,acc,0,0,0,69520983,0
mgh132,2KNY311211,20210801_20210831,eda,0,0,0,8505733,0
mgh132,2KNY311211,20210801_20210831,temp,0,0,0,2126490,0
mgh136,2M4Y4111GW,20210801_20210831,acc,0,0,0,7010560,0
mgh136,2M4Y4111GW,20210801_20210831,eda,0,0,0,860678,0
mgh136,2M4Y4111GW,20210801_20210831,temp,0,0,0,215165,0
mgh136,2M4Y4111TD,20210801_20210831,acc,0,0,78,17945374,78
mgh136,2M4Y4111TD,20210801_20210831,eda,0,0,0,2204712,0
mgh136,2M4Y4111TD,20210801_20210831,temp,0,0,0,551188,0
mgh139,2M4Y4111JP,20210801_20210831,acc,0,0,0,3414350,0
mgh139,2M4Y4111JP,20210801_20210831,eda,0,0,0,426569,0
mgh139,2M4Y4111JP,20210801_20210831,temp,0,0,0,106640,0
mgh140,2KPY311186,20210801_20210831,acc,0,0,0,15476681,0
mgh140,2KPY311186,20210801_20210831,eda,0,0,0,1884115,0
mgh140,2KPY311186,20210801_20210831,temp,0,0,0,471030,0
mgh141,2M4Y4111G5,20210801_20210831,acc,0,0,0,35733569,0
mgh141,2M4Y4111G5,20210801_20210831,eda,0,0,0,4449915,0
mgh141,2M4Y4111G5,20210801_20210831,temp,0,0,0,1112512,0
fc153,2M4Y4111H3,20210901_20210930,acc,0,0,0,34149370,0
fc153,2M4Y4111H3,20210901_20210930,eda,0,0,0,4219688,0
fc153,2M4Y4111H3,20210901_20210930,temp,0,0,0,1054924,0
fc155,2M4Y4111JM,20210901_20210930,acc,0,0,0,41507710,0
fc155,2M4Y4111JM,20210901_20210930,eda,0,0,0,5081765,0
fc155,2M4Y4111JM,20210901_20210930,temp,0,0,0,1270470,0
fc157,2M4Y4111FK,20210901_20210930,acc,0,0,0,78403972,0
fc157,2M4Y4111FK,20210901_20210930,eda,0,0,0,9818748,0
fc157,2M4Y4111FK,20210901_20210930,temp,0,0,0,2454754,0
fc158,2M5Y41111N,20210901_20210930,acc,0,0,0,42323925,0
fc158,2M5Y41111N,20210901_20210930,eda,0,0,0,5182381,0
fc158,2M5Y41111N,20210901_20210930,temp,0,0,0,1295636,0
fc165,2M4Y4111X7,20210901_20210930,acc,0,0,0,37771850,0
fc165,2M4Y4111X7,20210901_20210930,eda,0,0,0,4714151,0
fc165,2M4Y4111X7,20210901_20210930,temp,0,0,0,1178565,0
fc176,2M4Y41113M,20210901_20210930,acc,0,0,0,2551210,0
fc176,2M4Y41113M,20210901_20210930,eda,0,0,0,318006,0
fc176,2M4Y41113M,20210901_20210930,temp,0,0,0,79520,0
fc176,2M4Y4111WN,20210901_20210930,acc,0,0,0,56057078,0
fc176,2M4Y4111WN,20210901_20210930,eda,0,0,0,7039527,0
fc176,2M4Y4111WN,20210901_20210930,temp,0,0,0,1759934,0
fc177,2M4Y4111TC,20210901_20210930,acc,0,0,0,28455260,0
fc177,2M4Y4111TC,20210901_20210930,eda,0,0,0,3562956,0
fc177,2M4Y4111TC,20210901_20210930,temp,0,0,0,890754,0
fc179,2M4Y4111Y5,20210901_20210930,acc,0,0,0,10328410,0
fc179,2M4Y4111Y5,20210901_20210930,eda,0,0,0,1281982,0
fc179,2M4Y4111Y5,20210901_20210930,temp,0,0,0,320505,0
fc184,2M4Y4111FM,20210901_20210930,acc,0,0,0,29026745,0
fc184,2M4Y4111FM,20210901_20210930,eda,0,0,0,3575905,0
fc184,2M4Y4111FM,20210901_20210930,temp,0,0,0,893988,0
fc185,2M4Y4111JH,20210901_20210930,acc,0,0,0,48219720,0
fc185,2M4Y4111JH,20210901_20210930,eda,0,0,0,5164640,0
fc185,2M4Y4111JH,20210901_20210930,temp,0,0,0,1489985,0
fc188,2KNY3111QT,20210901_20210930,acc,0,0,0,11905330,0
fc188,2KNY3111QT,20210901_20210930,eda,0,0,0,1492231,0
fc188,2KNY3111QT,20210901_20210930,temp,0,0,0,373065,0
fc190,2M4Y4111RV,20210901_20210930,acc,0,0,0,0,0
fc190,2M4Y4111RV,20210901_20210930,eda,0,0,0,0,0
fc190,2M4Y4111RV,20210901_20210930,temp,0,0,0,5,0
fc191,2M4Y4111HT,20210901_20210930,acc,0,0,0,770210,0
fc191,2M4Y4111HT,20210901_20210930,eda,0,0,0,94770,0
fc191,2M4Y4111HT,20210901_20210930,temp,0,0,0,23690,0
fc192,2KNY3111X2,20210901_20210930,acc,0,0,0,10008580,0
fc192,2KNY3111X2,20210901_20210930,eda,0,0,0,1259037,0
fc192,2KNY3111X2,20210901_20210930,temp,0,0,0,314770,0
fc193,2M4Y4111VX,20210901_20210930,acc,0,0,0,4154890,0
fc193,2M4Y4111VX,20210901_20210930,eda,0,0,0,519636,0
fc193,2M4Y4111VX,20210901_20210930,temp,0,0,0,129905,0
fc194,2M4Y4111J5,20210901_20210930,acc,0,0,0,7080,0
fc194,2M4Y4111J5,20210901_20210930,eda,0,0,0,871,0
fc194,2M4Y4111J5,20210901_20210930,temp,0,0,0,215,0
fc195,2M4Y4111J7,20210901_20210930,acc,0,0,0,553357,0
fc195,2M4Y4111J7,20210901_20210930,eda,0,0,0,68266,0
fc195,2M4Y4111J7,20210901_20210930,temp,0,0,0,17068,0
fc196,2M4Y4111QN,20210901_20210930,acc,0,0,0,13886900,0
fc196,2M4Y4111QN,20210901_20210930,eda,0,0,0,1722838,0
fc196,2M4Y4111QN,20210901_20210930,temp,0,0,0,430705,0
fc197,2KPY31117K,20210901_20210930,acc,0,0,0,2111000,0
fc197,2KPY31117K,20210901_20210930,eda,0,0,0,263042,0
fc197,2KPY31117K,20210901_20210930,temp,0,0,0,65760,0
fc198,2M4Y4111HG,20210901_20210930,acc,0,0,0,3936840,0
fc198,2M4Y4111HG,20210901_20210930,eda,0,0,0,491283,0
fc198,2M4Y4111HG,20210901_20210930,temp,0,0,0,122825,0
fc199,2M4Y4111F3,20210901_20210930,acc,0,0,0,3560420,0
fc199,2M4Y4111F3,20210901_20210930,eda,0,0,0,447780,0
fc199,2M4Y4111F3,20210901_20210930,temp,0,0,0,111951,0
fc200,2M4Y41113G,20210901_20210930,acc,0,0,0,6220210,0
fc200,2M4Y41113G,20210901_20210930,eda,0,0,0,779253,0
fc200,2M4Y41113G,20210901_20210930,temp,0,0,0,194811,0
fc201,2KNY3111QT,20210901_20210930,acc,0,0,0,374217,0
fc201,2KNY3111QT,20210901_20210930,eda,0,0,0,47283,0
fc201,2KNY3111QT,20210901_20210930,temp,0,0,0,11822,0
fc201,2M4Y4111F3,20210901_20210930,acc,0,0,0,257854,0
fc201,2M4Y4111F3,20210901_20210930,eda,0,0,0,32656,0
fc201,2M4Y4111F3,20210901_20210930,temp,0,0,0,8164,0
mgh130,2KPY31118N,20210901_20210930,acc,0,0,0,12697790,0
mgh130,2KPY31118N,20210901_20210930,eda,0,0,0,1571427,0
mgh130,2KPY31118N,20210901_20210930,temp,0,0,0,392845,0
mgh132,2KNY311211,20210901_20210930,acc,0,0,0,67689149,0
mgh132,2KNY311211,20210901_20210930,eda,0,0,0,8279134,0
mgh132,2KNY311211,20210901_20210930,temp,0,0,0,2069853,0
mgh136,2M4Y4111TD,20210901_20210930,acc,0,0,0,10828123,0
mgh136,2M4Y4111TD,20210901_20210930,eda,0,0,0,1335522,0
mgh136,2M4Y4111TD,20210901_20210930,temp,0,0,0,333886,0
mgh139,2M4Y4111JP,20210901_20210930,acc,0,0,0,13378429,0
mgh139,2M4Y4111JP,20210901_20210930,eda,0,0,0,1671789,0
mgh139,2M4Y4111JP,20210901_20210930,temp,0,0,0,417962,0
mgh140,2KPY311186,20210901_20210930,acc,0,0,0,17712577,0
mgh140,2KPY311186,20210901_20210930,eda,0,0,0,2160792,0
mgh140,2KPY311186,20210901_20210930,temp,0,0,0,540209,0
mgh141,2M4Y4111G5,20210901_20210930,acc,0,0,0,51230839,0
mgh141,2M4Y4111G5,20210901_20210930,eda,0,0,0,6384268,0
mgh141,2M4Y4111G5,20210901_20210930,temp,0,0,0,1596107,0
mgh148,1FQYH1112C,20210901_20210930,acc,0,0,0,3386861,0
mgh148,1FQYH1112C,20210901_20210930,eda,0,0,0,428767,0
mgh148,1FQYH1112C,20210901_20210930,temp,0,0,0,107188,0
mgh150,2M4Y41113T,20210901_20210930,acc,0,0,0,17593440,0
mgh150,2M4Y41113T,20210901_20210930,eda,0,0,0,2187523,0
mgh150,2M4Y41113T,20210901_20210930,temp,2,0,3,546910,5
mgh151,2M5Y411123,20210901_20210930,acc,0,0,0,1151490,0
mgh151,2M5Y411123,20210901_20210930,eda,0,0,0,143416,0
mgh151,2M5Y411123,20210901_20210930,temp,0,0,0,35860,0
mgh152,1FQYH111C5,20210901_20210930,acc,0,0,0,14155609,0
mgh152,1FQYH111C5,20210901_20210930,eda,0,0,0,1776959,0
mgh152,1FQYH111C5,20210901_20210930,temp,0,0,0,444263,0
mgh153,2M4Y4111J1,20210901_20210930,acc,0,0,0,5026310,0
mgh153,2M4Y4111J1,20210901_20210930,eda,0,0,0,622388,0
mgh153,2M4Y4111J1,20210901_20210930,temp,0,0,0,155600,0
mgh154,2M4Y411134,20210901_20210930,acc,0,0,0,44943888,0
mgh154,2M4Y411134,20210901_20210930,eda,0,0,0,5587073,0
mgh154,2M4Y411134,20210901_20210930,temp,0,0,0,1396804,0
fc153,2M4Y4111H3,20211001_20211031,acc,0,0,0,43352067,0
fc153,2M4Y4111H3,20211001_20211031,eda,0,0,0,5349558,0
fc153,2M4Y4111H3,20211001_20211031,temp,0,0,0,1337416,0
fc155,2M4Y4111JM,20211001_20211031,acc,0,0,0,2161540,0
fc155,2M4Y4111JM,20211001_20211031,eda,0,0,0,264914,0
fc155,2M4Y4111JM,20211001_20211031,temp,0,0,0,66225,0
fc157,2M4Y4111FK,20211001_20211031,acc,0,0,0,71881022,0
fc157,2M4Y4111FK,20211001_20211031,eda,0,0,0,8995642,0
fc157,2M4Y4111FK,20211001_20211031,temp,0,0,0,2248970,0
fc158,2M5Y41111N,20211001_20211031,acc,0,0,0,2980943,0
fc158,2M5Y41111N,20211001_20211031,eda,0,0,0,364013,0
fc158,2M5Y41111N,20211001_20211031,temp,0,0,0,91013,0
fc165,2M4Y4111X7,20211001_20211031,acc,0,0,0,5384790,0
fc165,2M4Y4111X7,20211001_20211031,eda,0,0,0,671671,0
fc165,2M4Y4111X7,20211001_20211031,temp,0,0,0,167920,0
fc176,2M4Y4111WN,20211001_20211031,acc,0,0,0,73823288,0
fc176,2M4Y4111WN,20211001_20211031,eda,0,0,0,9276394,0
fc176,2M4Y4111WN,20211001_20211031,temp,0,0,0,2319168,0
fc177,2M4Y4111TC,20211001_20211031,acc,0,0,0,33690155,0
fc177,2M4Y4111TC,20211001_20211031,eda,0,0,0,4231927,0
fc177,2M4Y4111TC,20211001_20211031,temp,0,0,0,1057994,0
fc184,2M4Y4111FM,20211001_20211031,acc,0,0,0,7559960,0
fc184,2M4Y4111FM,20211001_20211031,eda,0,0,0,933296,0
fc184,2M4Y4111FM,20211001_20211031,temp,0,0,0,233325,0
fc185,2M4Y4111JH,20211001_20211031,acc,0,0,0,29065950,0
fc185,2M4Y4111JH,20211001_20211031,eda,0,0,0,3605654,0
fc185,2M4Y4111JH,20211001_20211031,temp,0,0,0,901435,0
fc195,2M4Y4111J7,20211001_20211031,acc,0,0,0,8434085,0
fc195,2M4Y4111J7,20211001_20211031,eda,0,0,0,1040042,0
fc195,2M4Y4111J7,20211001_20211031,temp,0,0,0,260022,0
fc196,2M4Y4111QN,20211001_20211031,acc,0,0,0,2303120,0
fc196,2M4Y4111QN,20211001_20211031,eda,0,0,0,286416,0
fc196,2M4Y4111QN,20211001_20211031,temp,0,0,0,71605,0
fc197,2KPY31117K,20211001_20211031,acc,0,0,0,31404445,0
fc197,2KPY31117K,20211001_20211031,eda,0,0,0,3871373,0
fc197,2KPY31117K,20211001_20211031,temp,0,0,0,967863,0
fc199,2M4Y4111F3,20211001_20211031,acc,0,0,0,27957168,0
fc199,2M4Y4111F3,20211001_20211031,eda,0,0,0,3507583,0
fc199,2M4Y4111F3,20211001_20211031,temp,0,0,0,876918,0
fc200,2M4Y41113G,20211001_20211031,acc,0,0,0,63500088,0
fc200,2M4Y41113G,20211001_20211031,eda,0,0,0,7954282,0
fc200,2M4Y41113G,20211001_20211031,temp,0,0,0,1988612,0
fc201,2KNY3111QT,20211001_20211031,acc,0,0,0,7974900,0
fc201,2KNY3111QT,20211001_20211031,eda,0,0,0,998257,0
fc201,2KNY3111QT,20211001_20211031,temp,0,0,0,249560,0
fc202,2M4Y4111RN,20211001_20211031,acc,0,0,0,4534152,0
fc202,2M4Y4111RN,20211001_20211031,eda,0,0,0,571398,0
fc202,2M4Y4111RN,20211001_20211031,temp,0,0,0,142855,0
fc205,2KNY3111N4,20211001_20211031,acc,0,0,0,1131,0
fc205,2KNY3111N4,20211001_20211031,eda,0,0,0,142,0
fc205,2KNY3111N4,20211001_20211031,temp,0,0,0,38,0
fc207,2M4Y4111VR,20211001_20211031,acc,0,0,0,130710,0
fc207,2M4Y4111VR,20211001_20211031,eda,0,0,0,16133,0
fc207,2M4Y4111VR,20211001_20211031,temp,0,0,0,4035,0
fc208,2KPY31119H,20211001_20211031,acc,0,0,0,242136,0
fc208,2KPY31119H,20211001_20211031,eda,0,0,0,30703,0
fc208,2KPY31119H,20211001_20211031,temp,0,0,0,7676,0
fc209,2KPY311184,20211001_20211031,acc,0,0,0,1184433,0
fc209,2KPY311184,20211001_20211031,eda,0,0,0,145101,0
fc209,2KPY311184,20211001_20211031,temp,0,0,0,36272,0
fc210,2M4Y4111J3,20211001_20211031,acc,0,0,0,2729,0
fc210,2M4Y4111J3,20211001_20211031,eda,0,0,0,345,0
fc210,2M4Y4111J3,20211001_20211031,temp,0,0,0,87,0
fc211,2M5Y41111N,20211001_20211031,acc,0,0,0,447630,0
fc211,2M5Y41111N,20211001_20211031,eda,0,0,0,55328,0
fc211,2M5Y41111N,20211001_20211031,temp,0,0,0,13830,0
fc213,2M4Y4111VT,20211001_20211031,acc,0,0,0,5799,0
fc213,2M4Y4111VT,20211001_20211031,eda,0,0,0,732,0
fc213,2M4Y4111VT,20211001_20211031,temp,0,0,0,183,0
mgh130,2KNY31122L,20211001_20211031,acc,0,0,0,63437908,0
mgh130,2KNY31122L,20211001_20211031,eda,0,0,0,7840149,0
mgh130,2KNY31122L,20211001_20211031,temp,0,0,0,1960078,0
mgh132,2KNY311211,20211001_20211031,acc,0,0,0,59150734,0
mgh132,2KNY311211,20211001_20211031,eda,0,0,0,7229102,0
mgh132,2KNY311211,20211001_20211031,temp,0,0,0,1807315,0
mgh136,2M4Y4111TD,20211001_20211031,acc,0,0,0,19241950,0
mgh136,2M4Y4111TD,20211001_20211031,eda,0,0,0,2375607,0
mgh136,2M4Y4111TD,20211001_20211031,temp,0,0,0,593910,0
mgh139,2M4Y4111JP,20211001_20211031,acc,0,0,0,12329189,0
mgh139,2M4Y4111JP,20211001_20211031,eda,0,0,0,1542431,0
mgh139,2M4Y4111JP,20211001_20211031,temp,0,0,0,385612,0
mgh140,2KPY311186,20211001_20211031,acc,0,0,0,6913900,0
mgh140,2KPY311186,20211001_20211031,eda,0,0,0,843063,0
mgh140,2KPY311186,20211001_20211031,temp,0,0,0,210770,0
mgh141,1FPYG1111X,20211001_20211031,acc,0,0,0,22647580,0
mgh141,1FPYG1111X,20211001_20211031,eda,0,0,0,2783807,0
mgh141,1FPYG1111X,20211001_20211031,temp,0,0,0,695955,0
mgh150,2M4Y41113T,20211001_20211031,acc,0,0,0,33423655,0
mgh150,2M4Y41113T,20211001_20211031,eda,0,0,0,4154179,0
mgh150,2M4Y41113T,20211001_20211031,temp,0,0,0,1038569,0
mgh152,1FQYH111C5,20211001_20211031,acc,0,0,0,44632921,0
mgh152,1FQYH111C5,20211001_20211031,eda,0,0,0,5599196,0
mgh152,1FQYH111C5,20211001_20211031,temp,0,0,0,1399882,0
mgh154,2M4Y411134,20211001_20211031,acc,0,0,0,39810310,0
mgh154,2M4Y411134,20211001_20211031,eda,0,0,0,4962124,0
mgh154,2M4Y411134,20211001_20211031,temp,0,0,0,1240560,0
mgh157,2KNY3111NN,20211001_20211031,acc,0,0,0,5237210,0
mgh157,2KNY3111NN,20211001_20211031,eda,0,0,0,657566,0
mgh157,2KNY3111NN,20211001_20211031,temp,0,0,0,164395,0
mgh158,2M4Y41123K,20211001_20211031,acc,0,0,0,7523620,0
mgh158,2M4Y41123K,20211001_20211031,eda,0,0,0,948220,0
mgh158,2M4Y41123K,20211001_20211031,temp,0,0,0,237060,0
fc176,2M4Y4111WN,20211101_20211130,acc,0,0,0,57982431,0
fc176,2M4Y4111WN,20211101_20211130,eda,0,0,0,7289744,0
fc176,2M4Y4111WN,20211101_20211130,temp,0,0,0,1822461,0
fc177,2M4Y4111TC,20211101_20211130,acc,0,0,0,28463803,0
fc177,2M4Y4111TC,20211101_20211130,eda,0,0,0,3570775,0
fc177,2M4Y4111TC,20211101_20211130,temp,0,0,0,892713,0
fc184,2M4Y4111FM,20211101_20211130,acc,0,0,317,1724460,317
fc184,2M4Y4111FM,20211101_20211130,eda,0,0,0,212992,0
fc184,2M4Y4111FM,20211101_20211130,temp,0,0,0,53240,0
fc185,2M4Y4111JH,20211101_20211130,acc,0,0,0,39902908,0
fc185,2M4Y4111JH,20211101_20211130,eda,0,0,0,4944696,0
fc185,2M4Y4111JH,20211101_20211130,temp,0,0,0,1236209,0
fc195,2M4Y4111J7,20211101_20211130,acc,0,0,0,5784464,0
fc195,2M4Y4111J7,20211101_20211130,eda,0,0,0,713387,0
fc195,2M4Y4111J7,20211101_20211130,temp,0,0,0,178348,0
fc197,2KPY31117K,20211101_20211130,acc,0,0,0,22677913,0
fc197,2KPY31117K,20211101_20211130,eda,0,0,0,2797337,0
fc197,2KPY31117K,20211101_20211130,temp,0,0,0,699346,0
fc199,2M4Y4111F3,20211101_20211130,acc,0,0,0,11619100,0
fc199,2M4Y4111F3,20211101_20211130,eda,0,0,0,1464684,0
fc199,2M4Y4111F3,20211101_20211130,temp,0,0,0,366175,0
fc200,2M4Y41113G,20211101_20211130,acc,0,0,0,21100881,0
fc200,2M4Y41113G,20211101_20211130,eda,0,0,0,2647810,0
fc200,2M4Y41113G,20211101_20211130,temp,0,0,0,661969,0
fc209,2KPY311184,20211101_20211130,acc,0,0,0,394560,0
fc209,2KPY311184,20211101_20211130,eda,0,0,0,48334,0
fc209,2KPY311184,20211101_20211130,temp,0,0,0,12085,0
fc210,2M4Y4111J3,20211101_20211130,acc,0,0,0,12329630,0
fc210,2M4Y4111J3,20211101_20211130,eda,0,0,0,1552356,0
fc210,2M4Y4111J3,20211101_20211130,temp,0,0,0,388105,0
fc211,2M5Y41111N,20211101_20211130,acc,0,0,0,35172510,0
fc211,2M5Y41111N,20211101_20211130,eda,0,0,0,4294030,0
fc211,2M5Y41111N,20211101_20211130,temp,0,0,0,1073530,0
fc213,2M4Y4111VT,20211101_20211130,acc,0,0,0,7536570,0
fc213,2M4Y4111VT,20211101_20211130,eda,0,0,0,939510,0
fc213,2M4Y4111VT,20211101_20211130,temp,0,0,0,234875,0
fc214,2M4Y4111FK,20211101_20211130,acc,0,0,0,87580,0
fc214,2M4Y4111FK,20211101_20211130,eda,0,0,0,11076,0
fc214,2M4Y4111FK,20211101_20211130,temp,0,0,0,2765,0
fc218,2KPY311199,20211101_20211130,acc,0,0,0,2171357,0
fc218,2KPY311199,20211101_20211130,eda,0,0,0,276349,0
fc218,2KPY311199,20211101_20211130,temp,0,0,0,69094,0
fc220,2M4Y4111J1,20211101_20211130,acc,0,0,0,18885427,0
fc220,2M4Y4111J1,20211101_20211130,eda,0,0,0,2337304,0
fc220,2M4Y4111J1,20211101_20211130,temp,0,0,0,584337,0
mgh130,2KNY31122L,20211101_20211130,acc,0,0,0,73200934,0
mgh130,2KNY31122L,20211101_20211130,eda,0,0,0,9045018,0
mgh130,2KNY31122L,20211101_20211130,temp,0,0,0,2261319,0
mgh132,2KNY311211,20211101_20211130,acc,0,0,0,49761499,0
mgh132,2KNY311211,20211101_20211130,eda,0,0,0,6087143,0
mgh132,2KNY311211,20211101_20211130,temp,0,0,0,1521806,0
mgh139,2M4Y4111JP,20211101_20211130,acc,0,0,0,8795180,0
mgh139,2M4Y4111JP,20211101_20211130,eda,0,0,0,1104246,0
mgh139,2M4Y4111JP,20211101_20211130,temp,0,0,0,276065,0
mgh140,2KPY311186,20211101_20211130,acc,0,0,0,781270,0
mgh140,2KPY311186,20211101_20211130,eda,0,0,0,95329,0
mgh140,2KPY311186,20211101_20211130,temp,0,0,0,23825,0
mgh150,2M4Y41113T,20211101_20211130,acc,0,0,0,38482243,0
mgh150,2M4Y41113T,20211101_20211130,eda,0,0,0,4777233,0
mgh150,2M4Y41113T,20211101_20211130,temp,0,0,0,1194350,0
mgh152,1FQYH111C5,20211101_20211130,acc,0,0,0,42206392,0
mgh152,1FQYH111C5,20211101_20211130,eda,0,0,0,5302617,0
mgh152,1FQYH111C5,20211101_20211130,temp,0,0,0,1325694,0
mgh158,2M4Y41123K,20211101_20211130,acc,0,0,0,30730847,0
mgh158,2M4Y41123K,20211101_20211130,eda,0,0,0,3862756,0
mgh158,2M4Y41123K,20211101_20211130,temp,0,0,0,965709,0
fc177,2M4Y4111TC,20211201_20211231,acc,0,0,0,187144,0
fc177,2M4Y4111TC,20211201_20211231,eda,0,0,0,23318,0
fc177,2M4Y4111TC,20211201_20211231,temp,0,0,0,5831,0
fc185,2M4Y4111JH,20211201_20211231,acc,0,0,0,61164786,0
fc185,2M4Y4111JH,20211201_20211231,eda,0,0,0,7542609,0
fc185,2M4Y4111JH,20211201_20211231,temp,0,0,0,1885711,0
fc195,2M4Y4111J7,20211201_20211231,acc,0,0,0,1040770,0
fc195,2M4Y4111J7,20211201_20211231,eda,0,0,0,130260,0
fc195,2M4Y4111J7,20211201_20211231,temp,0,0,0,32570,0
fc197,2KPY31117K,20211201_20211231,acc,0,0,0,3520230,0
fc197,2KPY31117K,20211201_20211231,eda,0,0,0,440089,0
fc197,2KPY31117K,20211201_20211231,temp,0,0,0,110030,0
fc200,2M4Y41113G,20211201_20211231,acc,0,0,0,24390407,0
fc200,2M4Y41113G,20211201_20211231,eda,0,0,0,3061591,0
fc200,2M4Y41113G,20211201_20211231,temp,0,0,0,765405,0
fc211,2M5Y41111N,20211201_20211231,acc,0,0,0,40217100,0
fc211,2M5Y41111N,20211201_20211231,eda,0,0,0,4914299,0
fc211,2M5Y41111N,20211201_20211231,temp,0,0,0,1228595,0
fc218,2KPY311199,20211201_20211231,acc,0,0,0,24278420,0
fc218,2KPY311199,20211201_20211231,eda,0,0,0,3042208,0
fc218,2KPY311199,20211201_20211231,temp,0,0,0,760565,0
fc220,2M4Y4111J1,20211201_20211231,acc,0,0,0,54772061,0
fc220,2M4Y4111J1,20211201_20211231,eda,0,0,0,6785212,0
fc220,2M4Y4111J1,20211201_20211231,temp,0,0,0,1696351,0
mgh130,2KNY31122L,20211201_20211231,acc,0,0,0,69725414,0
mgh130,2KNY31122L,20211201_20211231,eda,0,0,0,8620383,0
mgh130,2KNY31122L,20211201_20211231,temp,6,0,0,2155156,6
mgh132,2KNY311211,20211201_20211231,acc,0,0,0,54625823,0
mgh132,2KNY311211,20211201_20211231,eda,0,0,0,6680326,0
mgh132,2KNY311211,20211201_20211231,temp,0,0,0,1670109,0
mgh152,1FQYH111C5,20211201_20211231,acc,0,0,0,47245795,0
mgh152,1FQYH111C5,20211201_20211231,eda,0,0,0,5929575,0
mgh152,1FQYH111C5,20211201_20211231,temp,0,0,0,1482434,0
mgh158,2M4Y41123K,20211201_20211231,acc,0,0,0,31224643,0
mgh158,2M4Y41123K,20211201_20211231,eda,0,0,0,3907132,0
mgh158,2M4Y41123K,20211201_20211231,temp,0,0,0,976798,0
fc185,2M4Y4111JH,20220101_20220131,acc,0,0,0,45696575,0
fc185,2M4Y4111JH,20220101_20220131,eda,0,0,0,5635022,0
fc185,2M4Y4111JH,20220101_20220131,temp,0,0,0,1408788,0
fc197,2KPY31117K,20220101_20220131,acc,0,0,0,21567070,0
fc197,2KPY31117K,20220101_20220131,eda,0,0,0,2657733,0
fc197,2KPY31117K,20220101_20220131,temp,0,0,0,664435,0
fc200,2M4Y41113G,20220101_20220131,acc,0,0,0,1902990,0
fc200,2M4Y41113G,20220101_20220131,eda,0,0,0,238914,0
fc200,2M4Y41113G,20220101_20220131,temp,0,0,0,59725,0
fc211,2M5Y41111N,20220101_20220131,acc,0,0,0,9476100,0
fc211,2M5Y41111N,20220101_20220131,eda,0,0,0,1158430,0
fc211,2M5Y41111N,20220101_20220131,temp,0,0,0,289610,0
fc214,2M4Y4111FK,20220101_20220131,acc,0,0,0,3866670,0
fc214,2M4Y4111FK,20220101_20220131,eda,0,0,0,490789,0
fc214,2M4Y4111FK,20220101_20220131,temp,0,0,0,122700,0
fc218,2KPY311199,20220101_20220131,acc,0,0,0,26775761,0
fc218,2KPY311199,20220101_20220131,eda,0,0,0,3361796,0
fc218,2KPY311199,20220101_20220131,temp,0,0,0,840480,0
fc220,2M4Y4111J1,20220101_20220131,acc,0,0,0,15524010,0
fc220,2M4Y4111J1,20220101_20220131,eda,0,0,0,1939288,0
fc220,2M4Y4111J1,20220101_20220131,temp,0,0,0,484835,0
mgh132,2KNY311211,20220101_20220131,acc,0,0,0,7539033,0
mgh132,2KNY311211,20220101_20220131,eda,0,0,0,923265,0
mgh132,2KNY311211,20220101_20220131,temp,0,0,0,230803,0
mgh139,2M4Y4111JP,20220101_20220131,acc,0,0,0,6838770,0
mgh139,2M4Y4111JP,20220101_20220131,eda,0,0,0,855764,0
mgh139,2M4Y4111JP,20220101_20220131,temp,0,0,0,214020,0
mgh152,1FQYH111C5,20220101_20220131,acc,0,0,0,21035525,0
mgh152,1FQYH111C5,20220101_20220131,eda,0,0,0,2641554,0
mgh152,1FQYH111C5,20220101_20220131,temp,0,0,0,660413,0
mgh158,2M4Y41123K,20220101_20220131,acc,0,0,0,10899696,0
mgh158,2M4Y41123K,20220101_20220131,eda,0,0,0,1364450,0
mgh158,2M4Y41123K,20220101_20220131,temp,0,0,0,341111,0
fc197,2KPY31117K,20220201_20220228,acc,0,0,0,14758010,0
fc197,2KPY31117K,20220201_20220228,eda,0,0,0,1818063,0
fc197,2KPY31117K,20220201_20220228,temp,0,0,0,454530,0
fc211,2M5Y41111N,20220201_20220228,acc,0,0,0,2564200,0
fc211,2M5Y41111N,20220201_20220228,eda,0,0,0,313820,0
fc211,2M5Y41111N,20220201_20220228,temp,0,0,0,78450,0
fc218,2KPY311199,20220201_20220228,acc,0,0,0,27617498,0
fc218,2KPY311199,20220201_20220228,eda,0,0,0,3472493,0
fc218,2KPY311199,20220201_20220228,temp,0,0,0,868142,0
fc220,2M4Y4111J1,20220201_20220228,acc,0,0,0,7409450,0
fc220,2M4Y4111J1,20220201_20220228,eda,0,0,0,922831,0
fc220,2M4Y4111J1,20220201_20220228,temp,0,0,0,230715,0
mgh158,2KNY31122L,20220201_20220228,acc,0,0,0,36423986,0
mgh158,2KNY31122L,20220201_20220228,eda,0,0,0,4517379,0
mgh158,2KNY31122L,20220201_20220228,temp,0,0,0,1129379,0
fc218,2KPY311199,20220301_20220331,acc,0,0,0,11713278,0
fc218,2KPY311199,20220301_20220331,eda,0,0,0,1466918,0
fc218,2KPY311199,20220301_20220331,temp,0,0,0,366731,0
fc218,2M4Y4111JH,20220301_20220331,acc,0,0,0,18226330,0
fc218,2M4Y4111JH,20220301_20220331,eda,0,0,0,2249845,0
fc218,2M4Y4111JH,20220301_20220331,temp,0,0,0,562470,0
mgh211,2M4Y41113X,20220301_20220331,acc,0,0,16,60836457,16
mgh211,2M4Y41113X,20220301_20220331,eda,0,0,0,7537990,0
mgh211,2M4Y41113X,20220301_20220331,temp,0,0,0,1884541,0
mgh212,2M4Y411134,20220301_20220331,acc,0,0,0,60808178,0
mgh212,2M4Y411134,20220301_20220331,eda,0,0,0,7570347,0
mgh212,2M4Y411134,20220301_20220331,temp,0,0,0,1892642,0
fc218,2M4Y4111JH,20220401_20220430,acc,0,0,0,16329860,0
fc218,2M4Y4111JH,20220401_20220430,eda,0,0,0,2016963,0
fc218,2M4Y4111JH,20220401_20220430,temp,0,0,0,504245,0
mgh211,2M4Y41113X,20220401_20220430,acc,0,0,0,46554541,0
mgh211,2M4Y41113X,20220401_20220430,eda,0,0,0,5768208,0
mgh211,2M4Y41113X,20220401_20220430,temp,0,0,0,1442083,0
mgh212,2M4Y411134,20220401_20220430,acc,0,0,0,47273868,0
mgh212,2M4Y411134,20220401_20220430,eda,0,0,0,5887174,0
mgh212,2M4Y411134,20220401_20220430,temp,0,0,0,1471838,0
fc218,2KPY311199,20220501_20220531,acc,0,0,0,3133560,0
fc218,2KPY311199,20220501_20220531,eda,0,0,0,392886,0
fc218,2KPY311199,20220501_20220531,temp,0,0,0,98220,0
mgh212,2M4Y411134,20220501_20220531,acc,0,0,0,38717527,0
mgh212,2M4Y411134,20220501_20220531,eda,0,0,0,4813946,0
mgh212,2M4Y411134,20220501_20220531,temp,0,0,0,1203517,0
mgh212,2M4Y411134,20220601_20220630,acc,0,0,0,52584820,0
mgh212,2M4Y411134,20220601_20220630,eda,0,0,0,6541998,0
mgh212,2M4Y411134,20220601_20220630,temp,0,0,0,1635530,0
mgh212,2M4Y411134,20220701_20220731,acc,0,0,0,25822680,0
mgh212,2M4Y411134,20220701_20220731,eda,0,0,0,3210909,0
mgh212,2M4Y411134,20220701_20220731,temp,0,0,0,802750,0
mgh212,2M4Y411134,20220801_20220831,acc,0,0,0,2724650,0
mgh212,2M4Y411134,20220801_20220831,eda,0,0,0,338468,0
mgh212,2M4Y411134,20220801_20220831,temp,0,0,0,84620,0
